*LANG			
	&English	简体中文(&Simplified Chinese)	繁w中文(&Traditional Chinese)
	Warning	警告	警告
	Error	错误	e`
	no title	无标题	o祟}
	Unknown	未知	未知
	Freezing	冰冻	冰
	Poisoned	中毒	中毒
	Fire Resist	火焰抵抗	火焰抵抗
	Cold Resist	冰冷抵抗	冰冷抵抗
	Lightning Resist	闪电抵抗	W抵抗
	Normal	普通	普通
			
100	Foundry	铸造台	T造_
	Level	等级	等
	Owner	拥有者	碛姓
	Quality	质量	|量
	Defence	防御	防御
	Quantity	数量	盗
	Durability	耐久度	耐久度
	Property Transparency	属性悬浮窗透明度	傩腋〈巴该鞫
	Hide	隐藏	[藏
	Socket	有孔	有孔
	Indestructible	不可修复	不可修
	Ethereal	不可破坏	不可破
	Found	锻造	T造
	Prefix Suffix	前后缀	前后Y
	Add	添加	添加
	Edit	编辑	
	Delete	删除	h除
*=======================菜单项的提示信息			
	Create a new character	创建新角色	建新角色
	Open an existing character	打开现有角色	打_F有角色
	Save current character	保存当前角色	保存前角色
	Save current character to another file	用新文件保存当前角色	用新文件保存前角色
	Close current character	关闭当前角色；提示保存	P]前角色；提示保存
	Exit the application	退出应用程序；提示保存	退出用程序；提示保存
	Show/Hide toolbar	显示或隐藏工具栏	@示或[藏工具
	Show/Hide status bar	显示或隐藏状态栏	@示或[藏B
	"Show application info, version and license"	显示程序信息、版本号和版权	@示程序信息、版本和版
	Import an item from file	从文件导入一件装备	奈募入一件b
	Save the item to a file	将装备导出到文件	⒀bС龅轿募
	Copy the item	复制装备	}ub
	Paste the item copied	粘贴已复制的装备	粘N已}u的b
	Modify the item	修改装备的属性	修改b涞傩
	Create a new item	创建新装备	建新b
	Create a new item from current one	创建新装备并复制当前装备的属性	建新b洳⒀}u前b涞傩
	Remove the item	删除装备	h除b
*=======================角色物品UI弹出菜单			
	&Import	导入(&I)	入(&I)
	&Export	导出(&E)	С(&E)
	&Copy	复制(&C)	}u(&C)
	&Paste	粘贴(&P)	粘N(&P)
	&Modify	修改(&M)	修改(&M)
	&New	新建(&N)	新建(&N)
	&New from	从当前新建(&N)	漠前新建(&N)
	&Remove	删除(&R)	h除(&R)
*=======================系统菜单			
	&File	文件(&F)	文件(&F)
	&View	视图(&V)	D(&V)
	&Help	帮助(&H)	椭(&H)
	&New	新建(&N)	新建(&N)
	&Open	打开(&O)	打_(&O)
	&Save	保存(&S)	保存(&S)
	Save &As …	另存为(&A)…	另存(&A)…
	&Close	关闭(&C)	P](&C)
	E&xit	退出(&X)	退出(&X)
	Tool &Bar	工具栏(&B)	工具(&B)
	S&tatus Bar	状态栏(&T)	B(&T)
	&Language	语言(&L)	Z言(&L)
	&About Diablo Edit …	关于Diablo Edit(&A) …	P於Diablo Edit(&A) …
*=======================其他窗口UI			
	Please Choose a character class	请选择角色	x窠巧
	Amazon Skills	亚马逊技能	Rd技能
	Sorceress Skills	法师技能	法技能
	Necromancer Skills	死灵法师技能	死`法技能
	Paladin Skills	圣骑士技能	}T士技能
	Barbarian Skills	野蛮人技能	野U人技能
	Druid Skills	德鲁依技能	德依技能
	Assassin Skills	刺客技能	刺客技能
	All	全部	全部
	Items	物品	物品
*=======================新建物品窗口UI			
	New Item	创建物品	建物品
	Create	创建	建
	Cancel	取消	取消
*=======================铸造台窗口UI			
	Level	等级	等
	Owner	拥有者	碛姓
	Class	角色	角色
	Unidentified	未辨识	未辨R
	Ethereal	无形	o形
	Durability	耐久度	耐久度
	Indestructible	无法破坏	o法破
	Quantity	数量	盗
	Quality	质量	|量
	Sockets	镶孔	孔
	Defence	防御	防R
	Monster	怪物	怪物
	First Name	名字一	名字1
	Second Name	名字二	名字2
	Sub Type	子类	子
	Prefix 1	前缀1	前Y1
	Suffix 1	后缀1	後Y1
	Set Name	套装名称	套b名字
	Unique Name	暗金装备	暗金b
	Rune Word	符文之语	符文之Z
	Save	保存	保存
	Cancel	取消	取消
	Properties	属性	傩
	Set 1	套装1	套b1
	Set 2	套装2	套b2
	Set 3	套装3	套b3
	Set 4	套装4	套b4
	Set 5	套装5	套b5
	Rune Word	符文之语	符文之Z
	Code	代码	代a
	Description	说明	h明
*=======================物品属性悬浮窗口UI			
	Crude	粗糙的	粗糙的
	Superior	超强的	超的
	Defence: %d	防御: %d	防R: %d
	One Hand Damage: %d to %d	单手伤害: %d 到 %d	问害: %d 到 %d
	Two Hands Damage: %d to %d	双手伤害: %d 到 %d	p手害: %d 到 %d
	Quantity: %d	数量：%d	盗浚%d
	Durability: %d / %d	耐久度: %d 之 %d	耐久度: %d 之 %d
	Indestructible	无法破坏	o法破
	Ethereal(cannot be repaired)	无形的(无法修复)	o形的(o法修)
	Sockets(%d/%d)	有凹槽(%d/%d)	有凹槽(%d/%d)
	%s's Ear	(%s)的耳朵	(%s)的耳朵
	Level %d	%d级	%d
	Unidentified	未辨识	未辨R
*=======================角色装备信息UI			
	Sockets	孔	孔
	Iron Golem	金属石魔	金偈魔
	Cube	方块	方K
	Belt	腰带	腰
	Corpse	尸体	尸w
	Mercenary	雇佣兵	l虮
	Name	姓名	姓名
	Type	类型	型
	Exp.	经验	
	Dead	死亡	死亡
	Double click to resume	双击还原物品	p暨原物品
	Recycle	回收站	回收站
*=======================角色基本信息UI			
	Basic Info	基本信息	基本信息
	Waypoints	小站	小站
	Missions	任务	任
	Skills	技能	技能
	Mana	法力	法力
	Version	版本	版本
	Character	角色	角色
	Name	名字	名字
	Title	称谓	Q^
	Weapon	武器	武器
	Last game time	最近游戏时间	最近[rg
	Last position	最后位置	最後位置
	Level	等级	等
	Experience	经验	
	Level And Experience	等级与经验对照表	等cφ毡
	Character Stats	人物基本属性	人物基本傩
	Strength	力量	力量
	Dexterity	敏捷	敏捷
	Vitality	体力	w力
	Energy	精力	精力
	Stat Points	状态点剩余	Bc剩N
	Basic Value	基础值	基A值
	Current	当前值	前值
	Stamina	耐力	耐力
	Life	生命	生命
	Ladder	天梯	天梯
	Expansion	资料片	Y料片
	Hardcore	专家级	＜壹
	Died berfore	以前死过	以前死^
	Skill Points	技能点剩余	技能c剩N
	Gold in person	身上金钱	身上金X
	Gold in stash	箱子金钱	箱子金X
*=======================对话框消息			
	"Character name format error\nLength:  2-15 chars\nContent: a-z,A-Z,-,_\nCaution: name string starts and ends with chars,\nonly one '-' or '_' is allowed"	"人物名字格式错误\n长度：2-15个字符\n包括：a-z,A-Z,-,_\n注意：名字必须以字母开头和结尾，\n中间只允许有一个'-'或'_'符号"	"人物名字格式e`\nL度：2-15字符\n包括：a-z,A-Z,-,_\n注意：名字必以字母_^和Y尾\n中g只允S有一'-'或'_'符"
	Character level is between 1-127	人物等级必须在1-127之间	人物等必在1-127之g
	"Strength, Energy, Dexterity, Vitality and Stat Points is between 0-1023\nLife, Mana and Stamina is between 0-8191\nSkill Points is between 0-255"	力量、敏捷、体力、精力和状态点数必须在0-1023之间\n耐力、生命和法力值必须在0-8191之间\n技能点数必须在0-255之间	力量、敏捷、w力、精力和Bc抵当仨在0-1023之g\n耐力、生命和法力值必在0-8191之g\n技能c抵当仨在0-255之g
	Too many golds in person or stash	身上或箱子的金钱数过多	身上或箱子的金X颠^多
	Please choose character class	请选择一种角色	x褚环N角色
	Skill levels must be between 0-127	技能等级必须在0-127之间	技能等必在0-127之g
	(%c%c%c%c)Unrecognised Item Code	(%c%c%c%c)不能识别的物品代码	(%c%c%c%c)不可Re的物品代a
	Unkown Item Quality: iQuality = %d	未知的物品等级：iQuality = %d	未知的物品等：iQuality = %d
	Save the character %s ?	是否保存已打开的人物 %s ？	是否保存已打_的人物 %s  ？
	"Character name and file name are different, continue?"	人物名字与文件名不同，是否继续？	人物名字c文件名不同，是否^m？
			
11	The file isn't in d2s format	文件不是正确的d2s格式	文件不是正_的d2s格式
	File length is incorrect	文件长度错误	文件L度e`
	Quest info data format error	任务数据格式错误	任格式e`
	Waypoint info data format error	小站数据格式错误	小站格式e`
	Player Stats data format error	人物属性格式错误	人物傩愿袷藉e`
	Player Skills data format error	人物技能格式错误	人物技能格式e`
	Item List data format error	物品列表格式错误	物品列表格式e`
	Item data format error	物品格式错误	物品格式e`
	Corpse data format error	尸体数据格式错误	尸w格式e`
	Mercenary data format error	雇佣兵数据格式错误	l虮格式e`
	Golem data format error	Golem数据格式错误	Golem格式e`
	Ear level must be between 1 and 99	耳朵等级必须在1和99之间	耳朵等必在1和99之g
	Invalid character class	人物角色错误	人物角色e`
	Item drop level must be between 1 and 99	物品掉落等级必须在1和99之间	物品掉落等必在1和99之g
	Invalid item quality	物品质量错误	物品|量e`
	Invalid item subtype	物品子类错误	物品子e`
	Personalized name format error\nRequirement: 1-15 regular characters	个性化名字格式错误\n要求：1-15个英文字符	性化名字格式e`\n要求：1-15英文字符
	Item defence must be between 10 and 2057	物品防御必须在10到2057之间	物品防R必在10到2057之g
	Item max durability must be between 0 and 255	物品最大耐久度必须在0到255之间	物品最大耐久度必在0到255之g
	Item durability must be within max durability	物品耐久度必须在最大值范围内	物品耐久度必在最大值
	Item sockets count must be within 6	物品最多只能有6个孔	物品最多只能有6孔
	Quantity must be between 0 and 511	数量值必须在0到511之间	盗恐当仨在0到511之g
	Invalid monster name index	怪物名字索引错误	怪物名字所以e`
	Invalid first name index	物品名索引错误	物品名索引e`
	Invalid last name index	物品姓索引错误	物品姓索引e`
	Invalid prefix 1 index	物品前缀1索引错误	物品前Y1索引e`
	Invalid prefix 2 index	物品前缀2索引错误	物品前Y2索引e`
	Invalid prefix 3 index	物品前缀3索引错误	物品前Y3索引e`
	Invalid suffix 1 index	物品后缀1索引错误	物品後Y1索引e`
	Invalid suffix 2 index	物品后缀2索引错误	物品後Y2索引e`
	Invalid suffix 3 index	物品后缀3索引错误	物品後Y3索引e`
	Invalid set item name index	套装物品索引错误	套b物品索引e`
	Invalid unique item name index	暗金物品索引错误	暗金物品索引e`
	Invalid magic prefix index	物品魔法前缀索引错误	物品魔法前Y索引e`
	Invalid magic suffix index	物品魔法后缀索引错误	物品魔法後Y索引e`
	Invalid mercenary type index	雇佣兵类型错误	l虮型e`
	Invalid mercenary name index	雇佣兵名字错误	l虮名字e`
	Sockets must be enough for gems	物品孔数必须能容纳所有镶嵌的宝石	物品孔当仨能容{所有嵌的石
*=======================Barbarian类型雇佣兵名字			
1	Khan	可汗	
	Klisk		
	Bors		
	Brom		
	Wiglaf		
	Hrothgar		
	Scyld		
	Healfdane		
	Heorogar		
	Halgaunt		
	Hygelac		
	Egtheow		
	Bohdan		
	Wulfgar		
	Hild		
	Heatholaf		
	Weder		
	Vikhyat		
	Unferth		
	Sigemund		
	Heremod		
	Hengest		
	Folcwald		
	Frisian		
	Hnaef		
	Guthlaf		
	Oslaf		
	Yrmenlaf		
	Garmund		
	Freawaru		
	Eadgils		
	Onela		
	Damien		
	Erfor		
	Weohstan		
	Wulf		
	Bulwye		
	Lief		
	Magnus		
	Klatu		
	Drus		
	Hoku		
	Kord		
	Uther		
	Ip		
	Ulf		
	Tharr		
	Kaelim		
	Ulric		
	Alaric		
	Ethelred		
	Caden		
	Elgifu		
	Tostig		
	Alcuin		
	Emund		
	Sigurd		
	Gorm		
	Hollis		
	Ragnar		
	Torkel		
	Wulfstan		
	Alban		
	Barloc		
	Bill		
	Theodoric		
*=======================Eastern Sorceror类型雇佣兵名字			
1	Barani		
	Jabari		
	Devak		
	Raldin		
	Telash		
	Ajheed		
	Narphet		
	Khaleel		
	Phaet		
	Geshef		
	Vanji		
	Haphet		
	Thadar		
	Yatiraj		
	Rhadge		
	Yashied		
	Jarulf		
	Flux		
	Scorch		
*=======================Desert Mercenary类型雇佣兵名字			
1	Alhizeer		
	Azrael		
	Ahsab		
	Chalan		
	Haseen		
	Razan		
	Emilio		
	Pratham		
	Fazel		
	Jemali		
	Kasim		
	Gulzar		
	Mizan		
	Leharas		
	Durga		
	Neeraj		
	Ilzan		
	Zanarhi		
	Waheed		
	Vikhyat		
*=======================Rogue Scouts类型雇佣兵名字			
1	Amplisa		
	Annor		
	Abhaya		
	Elly		
	Paige		
	Basanti		
	Blaise		
	Kyoko		
	Klaudia		
	Kundri		
	Kyle		
	Visala		
	Elexa		
	Floria		
	Fiona		
	Gwinni		
	Gaile		
	Hannah		
	Heather		
	Iantha		
	Diane		
	Isolde		
	Divo		
	Ithera		
	Itonya		
	Liene		
	Maeko		
	Mahala		
	Liaza		
	Meghan		
	Olena		
	Oriana		
	Ryann		
	Rozene		
	Raissa		
	Sharyn		
	Shikha		
	Debi		
	Tylena		
	Wendy		
*=======================雇佣兵类型名字			
	Scout - Normal - Fire Arrow		
	Scout - Normal - Cold Arrow		
	Scout - Nightmare - Fire Arrow		
	Scout - Nightmare - Cold Arrow		
	Scout - Hell - Fire Arrow		
	Scout - Hell - Cold Arrow		
	Mercenary - Normal - Combat		
	Mercenary - Normal - Defensive		
	Mercenary - Normal - Offensive		
	Mercenary - Nightmare - Combat		
	Mercenary - Nightmare - Defensive		
	Mercenary - Nightmare - Offensive		
	Mercenary - Hell - Combat		
	Mercenary - Hell - Defensive	沙漠雇佣兵 - 地狱 - 防御型	
	Mercenary - Hell - Offensive		
	Sorceror - Normal - Fire Spells		
	Sorceror - Normal - Cold Spells		
	Sorceror - Normal - Lightning Spells		
	Sorceror - Nightmare - Fire Spells		
	Sorceror - Nightmare - Cold Spells		
	Sorceror - Nightmare - Lightning Spells		
	Sorceror - Hell - Fire Spells		
	Sorceror - Hell - Cold Spells		
	Sorceror - Hell - Lightning Spells		
	Barbarian - Normal		
	Barbarian - Normal		
	Barbarian - Nightmare		
	Barbarian - Nightmare		
	Barbarian - Hell		
	Barbarian - Hell		
*=======================物品种类名字			
	General items	一般物品	一般物品
	Helmets	头盔	^盔
	Helmets (Barbarian only)	野蛮人专用头盔	野U人Ｓ妙^盔
	Helmets (Druid only)	德鲁伊专用头盔	德伊Ｓ妙^盔
	Gloves	手套	手套
	Boots	鞋子	鞋子
	Belts	腰带	腰
	Armors	护甲	o甲
	Shields	盾牌	盾牌
	Shields (Paladin only)	圣骑士专用盾牌	}T士Ｓ枚芘
	Shields (Necromancer only)	死灵法师专用盾牌	死`法Ｓ枚芘
	Axes	斧头	斧^
	Wands (Necromancer only)	死灵法师专用法杖	死`法Ｓ梅ㄕ
	Clubs	棍棒	棍棒
	Scepters (Paladin only)	圣骑士专用杖	}T士Ｓ谜
	Swords	刀剑	刀
	Knifes	飞刀	w刀
	Javelins	标枪	
	Spears	长矛	L矛
	Staffs (Sorceress only)	法师专用法杖	法Ｓ梅ㄕ
	Bows	弓弩	弓弩
	Poisons	毒药	毒
	Quest Items	任务物品	任瘴锲
	Claws (Assasin only)	刺客专用刀爪	刺客Ｓ玫蹲
	Orbs (Sorceress only)	法师专用球	法Ｓ们
	Bow and spears (Amazon only)	亚马逊专用弓和矛	RdＳ霉和矛
*=======================物品质量名字			
	Low	白色低级	白色低
	Normal	白色普通	白色普通
	High	白色高级	白色高
	Magical	蓝色魔法	{色魔法
	Set	绿色套装	G色套b
	Rare	黄金装备	S金b
	Unique	暗金装备	暗金b
	Crafted	橙色合成	橙色合成
*=======================游戏难度			
	Normal	普通	普通
	Nightmare	恶梦	噩
	Hell	地狱	地z
*=======================小站名字			
	Rogue Encampment	萝格营地	}格I地
	Cold Plains	冰冷之原	冰冷之原
	Stony Field	石块旷野	石K缫
	Dark Wood	黑暗森林	黑暗森林
	Black Marsh	黑色荒地	黑色荒地
	Outer Cloister	外侧回廊	外绒廊
	Jail Level 1	监牢第一层	O牢第一
	Inner Cloister	内侧回廊	内绒廊
	Catacombs Level 2	地下墓穴第二层	地下墓穴第二
	Lut Gholein	鲁.高因	.高因
	Sewers Level 2	下水道第二层	下水道第二
	Dry Hills	干燥的高地	乾燥的高地
	Halls of the Dead Level 2	死亡之殿第二层	死亡之殿第二
	Far Oasis	遥远的绿洲	bh的G洲
	Lost City	遗失的城市	z失的城市
	Palace Cellar Level 1 	皇宫监牢第一层	皇mO牢第一
	Arcane Sanctuary	神秘避难所	神秘避y所
	Canyon of the Magi	卫士的峡谷	l士的{谷
	Kurast Docktown	库拉斯特海港	炖斯特海港
	Spider Forest	蜘蛛森林	蜘蛛森林
	Great Marsh	庞大湿地	大竦
	Flayer Jungle	剥皮森林	皮森林
	Lower Kurast	库拉斯特下层	炖斯特下
	Kurast Bazaar	库拉斯特商场	炖斯特商
	Upper Kurast	库拉斯特上层	炖斯特上
	Travincal	崔凡克	崔凡克
	Durance of Hate Level 2	憎恨的囚牢第二层	憎恨的囚牢第二
	The Pandemonium Fortress	群魔堡垒	群魔堡
	City of the Damned	神罚之城	神P之城
	River of Flame	火焰之河	火焰之河
	Harrogath	哈洛加斯	哈洛加斯
	Rigid Highlands	冰冻高地	冰龈叩
	Arreat Plateau	亚瑞特高原	瑞特高原
	Crystalline Passage	水晶通道	水晶通道
	Glacial Trail	冰河路径	冰河路
	Halls of Anguish	痛苦之厅	痛苦之a
	Tundra Wastelands	冰冻苔原	冰鎏υ
	The Ancients' way	远古之路	h古之路
	The Worldstone Keep Level 2	世界之石要塞第二层	世界之石要塞第二
*=======================任务名字			
	Den of Evil	邪恶洞穴	邪憾囱
	Sisters' Burial Grounds	修女埋骨之地	修女埋骨之地
	The Search for Cain	凯恩的搜索	P恩的搜索
	The Forgotten Tower	遗忘之塔	z忘之塔
	Tools of the Trade	交易的工具	交易的工具
	Sisters to the Slaughter	屠杀的修女	屠⒌男夼
	Radament's Lair	罗达门特的巢穴	__T特的巢穴
	The Horadric Staff	赫拉迪克之杖	赫拉迪克之杖
	Tainted Sun	堕落的太阳	落的太
	Arcane Sanctuary	神秘避难所	神秘避y所
	The Summoner	召唤者	召菊
	The Seven Tombs	七个古墓	七古墓
	The Golden Bird	黄金鸟	S金B
	Blade of the Old Religion	古代宗教之刃	古代宗教之刃
	Khalim's Will	克林姆的意志	克林姆的意志
	Lam Esen's Tome	蓝.依森的古书	{.依森的古
	The Blackened Temple	转为黑暗的神殿	D黑暗的神殿
	The Guardian	守护者	守o者
	The Fallen Angel	堕落的天使	落的天使
	Hell's Forge	地狱熔炉	地z熔t
	Terror's End	恐怖的结局	恐怖的Y局
	Siege on Harrogath	哈洛加斯围城战	哈洛加斯城
	Rescue on Mount Arreat	亚瑞特山的救援行动	瑞特山的救援行
	Prison of Ice	冰之囚	冰之囚
	Betrayal of Harrogath	哈洛加斯的反叛行动	哈洛加斯的反叛行
	Rite of Passage	通道的祭典	通道的祭典
	Eve of Destruction	毁灭的前夕	绲那跋
	Moo Moo Farm	杀死母牛之王	⑺滥概Ｖ王
	Reset Stats Points	重置技能和属性点	重置技能和傩渣c
*=======================通用技能名字			
	Attack	一般攻击	一般攻
	Kick	脚踢	_踢
	Throw	投掷	投S
	Unsummon	取消召唤	取消召
	Left Hand Throw	左手投掷	左手投S
	Left Hand Swing	左手挥动	左手]
	Scroll of Identify	辨识卷轴	辨R卷S
	Tome of Identify	辨识之书	辨R之
	Scroll of Town Portal	回城卷轴	回城卷S
	Tome of Town Portal	回城之书	回城之
	Delirium	迪勒瑞姆	迪勒瑞姆
	An Evil Force	一股邪恶力量	一股邪毫α
*=======================角色技能名字			
	Magic Arrow	魔法箭	魔法箭
	Fire Arrow	火焰箭	火焰箭
	Cold Arrow	冰箭	冰箭
	Multiple Shot	多重箭	多重箭
	Exploding Arrow	爆裂箭	爆裂箭
	Ice Arrow	急冻箭	急黾
	Guided Arrow	导引箭	б箭
	Strafe	炮轰	hZ
	Immolation Arrow	牺牲之箭	奚之箭
	Freezing Arrow	冻结之箭	鼋Y之箭
	Inner Sight	内视	内
	Critical Strike	致命攻击	致命攻
	Dodge	闪避	W避
	Slow Missiles	慢速箭	慢速箭
	Avoid	躲避	躲避
	Penetrate	刺入	刺入
	Dopplezon	诱饵	TD
	Evade	回避	避
	Valkyrie	女武神	女武神
	Pierce	穿刺	穿刺
	Jab	戳刺	戳刺
	Power Strike	威力一击	威力一
	Poison Javelin	毒枪	毒
	Impale	刺爆	刺爆
	Lightning Bolt	闪电球	W球
	Charged Strike	充能一击	充能一
	Plague Javelin	瘟疫标枪	瘟疫
	Fend	击退	敉
	Lightning Strike	闪电攻击	W攻
	Lightning Fury	闪电之怒	W之怒
	Fire Bolt	火弹	火
	Warmth	暖气	暖
	Inferno	地狱之火	地z之火
	Blaze	炽烈之径	肓抑
	Fire Ball	火球	火球
	Fire Wall	火墙	火
	Enchant	强化	化
	Meteor	陨石	E石
	Fire Mastery	支配之焰	支配之焰
	Hydra	九头海蛇	九^海蛇
	Charged Bolt	充能弹	充能
	Static Field	静态力场	oB力
	Telekinesis	心灵传动	心`
	Nova	新星	新星
	Lightning	闪电	W
	Chain Lightning	连锁闪电	BiW
	Teleport	传送	魉
	Thunder Storm	雷云风暴	雷云L暴
	Energy Shield	能量护盾	能量o盾
	Lightning Mastery	支配闪电	支配W
	Ice Bolt	冰弹	冰
	Frozen Armor	冰封装甲	冰封b甲
	Frost Nova	霜之新星	霜之新星
	Ice Blast	冰风暴	冰L暴
	Shiver Armor	碎冰甲	碎冰甲
	Glacial Spike	冰尖柱	冰尖柱
	Blizzard	暴风雪	暴L雪
	Chilling Armor	寒冰装甲	寒冰b甲
	Frozen Orb	冰封球	冰封球
	Cold Mastery	支配冰冷	支配冰冷
	Amplify Damage	伤害加深	害加深
	Dim Vision	微暗灵视	微暗`
	Weaken	削弱	削弱
	Iron Maiden	攻击反噬	攻舴词
	Terror	恐惧	恐
	Confuse	迷乱	迷y
	Life Tap	偷取生命	偷取生命
	Attract	吸引	吸引
	Decrepify	衰老	衰老
	Lower Resist	降低抵抗	降低抵抗
	Teeth	牙	牙
	Bone Armor	白骨装甲	白骨b甲
	Poison Dagger	淬毒匕首	淬毒匕首
	Corpse Explosion	尸体爆炸	企w爆炸
	Bone Wall	骨墙	骨
	Poison Explosion	毒爆	毒爆
	Bone Spear	骨矛	骨矛
	Bone Prison	骨牢	骨牢
	Poison Nova	剧毒新星	《拘滦
	Bone Spirit	白骨之魂	白骨之魂
	Skeleton Mastery	支配骷髅	支配骷t
	Raise Skeleton	骷髅复苏	骷t彤d
	Clay Golem	黏土石魔	黏土石魔
	Golem Mastery	支配石魔	支配石魔
	Raise Skeletal Mage	复苏骷髅法师	彤d骷t法
	Blood Golem	鲜血石魔	r血石魔
	Summon Resist	召唤反抗	召痉纯
	Iron Golem	钢铁石魔	F石魔
	Fire Golem	火焰石魔	火焰石魔
	Revive	重生	重生
	Sacrifice	牺牲	奚
	Smite	重击	重
	Holy Bolt	圣光弹	}光
	Zeal	白热	白
	Charge	突击	突
	Vengeance	复仇	统
	Blessed Hammer	祝福之锤	祝福之m
	Conversion	转换	DQ
	Holy Shield	神圣之盾	神}之盾
	Fist of the Heavens	天堂之拳	天堂之拳
	Might	力量	力量
	Holy Fire	圣火	}火
	Thorns	刺针	刺
	Blessed Aim	祝福瞄准	祝福瞄
	Concentration	专注	Ｗ
	Holy Freeze	神圣冰冻	神}冰
	Holy Shock	神圣冲击	神}n
	Sanctuary	庇护所	庇o所
	Fanaticism	狂热	狂
	Conviction	信念	信念
	Prayer	祈祷	祈\
	Resist Fire	抗火	抗火
	Defiance	反抗	反抗
	Resist Cold	抗冰冷	抗冰冷
	Cleansing	净化	Q化
	Resist Lightning	抵抗闪电	抵抗W
	Vigor	精力	精力
	Meditation	冥思	冥思
	Redemption	救赎	救H
	Salvation	救助	救助
	Bash	重击	重
	Leap	跳跃	跳S
	Double Swing	双手挥击	p手]
	Stun	击昏	艋
	Double Throw	双手投掷	p手投S
	Leap Attack	跳跃攻击	跳S攻
	Concentrate	专心	Ｐ
	Frenzy	狂乱	狂y
	Whirlwind	旋风	旋L
	Berserk	狂战士	狂鹗
	Sword Mastery	支配长剑	支配L
	Axe Mastery	支配斧头	支配斧^
	Mace Mastery	支配钉头锤	支配^m
	Pole Arm Mastery	支配长棍	支配L棍
	Throwing Mastery	支配飞掷	支配wS
	Spear Mastery	支配长矛	支配L矛
	Increased Stamina	增加耐力	增加耐力
	Iron Skin	铁布衫	布衫
	Increased Speed	加速	加速
	Natural Resistance	自然抵抗	自然抵抗
	Howl	狂嗥	狂嗥
	Find Potion	找寻药剂	找に
	Taunt	嘲弄	嘲弄
	Shout	大叫	大叫
	Find Item	找寻物品	找の锲
	Battle Cry	战嗥	疣
	Battle Orders	战斗体制	痿Yw制
	Grim Ward	残酷喝阻	酷阻
	War Cry	战斗狂嗥	痿Y狂嗥
	Battle Command	战斗指挥	痿Y指]
	Raven	乌鸦	貘f
	Plague Poppy	猛毒华藤	猛毒花藤
	Oak Sage	橡木智者	橡木智者
	Summon Spirit Wolf	召唤鬼狼	召竟砝
	Cycle of Life	食尸藤	食铺
	Heart of Wolverine	狼獾之心	狼獾之心
	Summon Fenris	召唤狂狼	召究窭
	Vines	太阳藤	太藤
	Spirit of Barbs	棘灵	棘`
	Summon Grizzly	召唤灰熊	召净倚
	Wearwolf	狼人变化	狼人化
	Shape Shifting	变形术	形X
	Wearbear	熊人变化	熊人化
	Feral Rage	野性狂暴	野性狂暴
	Maul	撞槌	撞m
	Rabies	狂犬病	狂犬病
	Fire Claws	焰爪	焰爪
	Hunger	饥饿	|I
	Shock Wave	震波	震波
	Fury	狂怒	狂怒
	Firestorm	火风暴	火L暴
	Molten Boulder	熔浆巨岩	熔{巨岩
	Arctic Blast	极地风暴	O地L暴
	Eruption	火山爆	火山爆
	Cyclone Armor	飓风装甲	ZLb甲
	Twister	镰鼬风	`鼬L
	Volcano	火山	火山
	Tornado	龙卷风	燥L
	Armageddon	毁天灭地	天绲
	Hurricane	暴风	暴L
	Fire Trauma	火焰爆震	火焰爆震
	Shock Field	雷电网	雷W
	Blade Sentinel	刃之守卫	刃之守l
	Charged Bolt Sentry	电能守卫	能守l
	Wake of Fire Sentry	火焰复苏	火焰彤d
	Blade Fury	刃之怒	刃之怒
	Lightning Sentry	雷光守卫	雷光守l
	Inferno Sentry	复苏狱火	彤dz火
	Death Sentry	亡者守卫	亡者守l
	Blade Shield	刀刃之盾	刀刃之盾
	Claw Mastery	支配利爪	支配利爪
	Psychic Hammer	心灵战锤	心`疰m
	Quickness	加速	加速
	Weapon Block	武器格挡	武器格
	Cloak of Shadows	魔影斗篷	魔影斗篷
	Fade	能量消解	能量消解
	Shadow Warrior	影子战士	影子鹗
	Mind Blast	心灵爆震	心`爆震
	Venom	毒牙	毒牙
	Shadow Master	影子大师	影子大
	Tiger Strike	虎击	虎
	Dragon Talon	龙爪	爪
	Fists of Fire	焰拳	焰拳
	Dragon Claw	双龙爪	p爪
	Cobra Strike	眼镜蛇攻击	眼R蛇攻
	Claws of Thunder	雷电爪	雷爪
	Dragon Tail	神龙摆尾	神[尾
	Blades of Ice	寒冰刃	寒冰刃
	Dragon Flight	飞龙在天	w在天
	Royal Strike	凤凰攻击	P凰攻
*=======================角色技能树名字（不是技能名）			
	Bow and Crossbow Skills	弓和十字弓技能	弓和十字弓技能
	Passive and Magic Skills	被动和魔法技能	被雍湍Х技能
	Javelin and Spear Skills	标枪和长矛技能	和L矛技能
	Fire Spells	火焰法术	火焰法g
	Lightning Spells	闪电法术	W法g
	Cold Spells	冰冻法术	冰龇ㄐg
	Curses	诅咒	{咒
	Poison and Bone Spells	毒素和白骨法术	毒素和白骨法g
	Summoning Spells	召唤法术	召痉ㄐg
	Combat Skills	作战技能	作鸺寄
	Offensive Auras	攻击灵气	攻綮`
	Defensive Auras	防御性灵气	防R性`
	Combat Skills	战斗技能	痿Y技能
	Combat Masteries	战斗专家	痿Y＜
	Warcries	呐喊	呐喊
	Summoning	召唤	召
	Lycanthropy	外型变形	外型形
	Elemental	元素	元素
	Traps	陷阱	陷阱
	Shadow Disciplines	影子训练	影子
	Martial Arts	武学艺术	武Wg
*=======================时刻名字			
	During Daytime	在白天	在白天
	Near Dusk	在黄昏	在S昏
	During Nighttime	在夜间	在夜g
	Near Dawn	在黎明	在黎明
*=======================角色名字			
	Amazon	亚马逊	Rd
	Sorceress	法师	法
	Necromancer	死灵法师	死`法
	Paladin	圣骑士	}T士
	Barbarian	野蛮人	野U人
	Druid	德鲁依	德依
	Assassin	刺客	刺客
*=======================以下是物品名称			
	Elixir		`
	Healing Potion		一股邪毫α
	Mana Potion		一股邪毫α
	Full Healing Potion		一股邪毫α
	Full Mana Potion		一股邪毫α
	Stamina Potion		w力
	Antidote Potion		解毒
	Rejuvenation Potion		回突盍λ
	Full Rejuvenation Potion		全面回突盍λ
	Thawing Potion		溶解
	Town Portal Book		城魉椭
	Identify Book		辨R之
	Amulet		o身符
	Top of The Horadric Staff		赫拉迪克之杖端
	Ring		戒指
	Gold		S金
	Scroll of Jnifuss		艾尼弗斯卷S
	Key To The Cairn Stones		石V之
	Arrows		箭矢
	Torch		火焰
	Bolts		十字弓
	Town Portal Scroll		城魉途磔S
	Identify Scroll		辨R卷S
	Heart		心K
	Brain		X
	Jawbone		骨
	Eye		眼球
	Horn		角
	Diablo's Horn	暗黑破坏神之角	暗黑破纳裰角
	Tail		尾巴
	Flag		旗
	Standard of Heroes	英雄旗帜	英雄旗
	Fang		尖牙
	Quill		硬毛
	Soul		`魂
	Scalp		^皮
	Spleen		脾K
	Key		匙
	The Black Tower Key		黑塔之
	Key of Terror	恐惧之钥	恐种
	Key of Hate	憎恨之钥	憎恨之
	Key of Destruction	毁灭之钥	缰
	Potion of Life		生命
	Jade Figurine		玉u小人
	Gold Bird		S金B
	Lam esen's tome		{.伊森之
	Horadric Cube		赫拉迪克方K
	Horadric Scroll		赫拉迪克卷S
	Mephisto SoulStone		墨菲斯托的`魂之石
	Book of Skill		技能之
	Khalim Eye		克林姆的眼球
	Baal's Eye	巴尔之眼	巴之眼
	Khalim Heart		克林姆的心K
	Khalim Brain		克林姆的大X
	Mephisto's Brain	墨菲斯托之脑	墨菲斯托之X
	Ear		耳朵
	Chipped Amethyst		碎裂的紫石
	Flawed Amethyst		裂_的紫石
	Amethyst		紫石
	Flawless Amethyst		o瑕疵的紫石
	Perfect Amethyst		完美的紫石
	Chipped Topaz		碎裂的黄石
	Flawed Topaz		裂_的黄石
	Topaz		黄石
	Flawless Topaz		o瑕疵的黄石
	Perfect Topaz		完美的黄石
	Chipped Saphire		碎裂的{石
	Flawed Saphire		裂_的{石
	Saphire		{石
	Flawless Saphire		o瑕疵的{石
	Perfect Saphire		完美的{石
	Chipped Emerald		碎裂的G石
	Flawed Emerald		裂_的G石
	Emerald		G石
	Flawless Emerald		o瑕疵的G石
	Perfect Emerald		完美的G石
	Chipped Ruby		碎裂的t石
	Flawed Ruby		裂_的t石
	Ruby		t石
	Flawless Ruby		o瑕疵的t石
	Perfect Ruby		完美的t石
	Chipped Diamond		碎裂的石
	Flawed Diamond		裂_的石
	Diamond		石
	Flawless Diamond		o瑕疵的石
	Perfect Diamond		完美的石
	Minor Healing Potion		p微治
	Light Healing Potion		p型治
	Healing Potion		治
	Greater Healing Potion		力
	Super Healing Potion		超治
	Minor Mana Potion		p微法力
	Light Mana Potion		p型法力
	Mana Potion		法力
	Greater Mana Potion		力法力
	Super Mana Potion		超法力
	Chipped Skull		碎裂的骷t
	Flawed Skull		裂_的骷t
	Skull		骷t
	Flawless Skull		o瑕疵的骷t
	Perfect Skull		完美的骷t
	Herb		草
	Small Charm		小o身符
	Large Charm		大型o身符
	Grand Charm		超大型o身符
	Small Red Potion		一股邪毫α
	Large Red Potion		一股邪毫α
	Small Blue Potion		一股邪毫α
	Large Blue Potion		一股邪毫α
	El Rune (1)	符文：El (1)	符文：El (1)
	Eld Rune (2)	符文：Eld (2)	符文：Eld (2)
	Tir Rune (3)	符文：Tir (3)	符文：Tir (3)
	Nef Rune (4)	符文：Nef (4)	符文：Nef (4)
	Eth Rune (5)	符文：Eth (5)	符文：Eth (5)
	Ith Rune (6)	符文：Ith (6)	符文：Ith (6)
	Tal Rune (7)	符文：Tal (7)	符文：Tal (7)
	Ral Rune (8)	符文：Ral (8)	符文：Ral (8)
	Ort Rune (9)	符文：Ort (9)	符文：Ort (9)
	Thul Rune (10)	符文：Thul (10)	符文：Thul (10)
	Amn Rune (11)	符文：Amn (11)	符文：Amn (11)
	Sol Rune (12)	符文：Sol (12)	符文：Sol (12)
	Shael Rune (13)	符文：Shael (13)	符文：Shael (13)
	Dol Rune (14)	符文：Dol (14)	符文：Dol (14)
	Hel Rune (15)	符文：Hel (15)	符文：Hel (15)
	Io Rune (16)	符文：Io (16)	符文：Io (16)
	Lum Rune (17)	符文：Lum (17)	符文：Lum (17)
	Ko Rune (18)	符文：Ko (18)	符文：Ko (18)
	Fal Rune (19)	符文：Fal (19)	符文：Fal (19)
	Lem Rune (20)	符文：Lem (20)	符文：Lem (20)
	Pul Rune (21)	符文：Pul (21)	符文：Pul (21)
	Um Rune (22)	符文：Um (22)	符文：Um (22)
	Mal Rune (23)	符文：Mal (23)	符文：Mal (23)
	Ist Rune (24)	符文：Ist (24)	符文：Ist (24)
	Gul Rune (25)	符文：Gul (25)	符文：Gul (25)
	Vex Rune (26)	符文：Vex (26)	符文：Vex (26)
	Ohm Rune (27)	符文：Ohm (27)	符文：Ohm (27)
	Lo Rune (28)	符文：Lo (28)	符文：Lo (28)
	Sur Rune (29)	符文：Sur (29)	符文：Sur (29)
	Ber Rune (30)	符文：Ber (30)	符文：Ber (30)
	Jah Rune (31)	符文：Jah (31)	符文：Jah (31)
	Cham Rune (32)	符文：Cham (32)	符文：Cham (32)
	Zod Rune (33)	符文：Zod (33)	符文：Zod (33)
	Jewel		石
	Malah's Potion		R拉之
	Scroll of Knowledge		知R卷S
	Scroll of Resistances		抵抗卷S
	Token of Absolution	赦免徽章	赦免徽章
	Twisted Essence of Destruction	溃烂的毁灭精华	的缇A
	Twisted Essence of Terror	燃烧的恐惧精华	燃的恐志A
	Twisted Essence of Hatred	充盈的憎恨精华	充盈的憎恨精A
	Twisted Essence of Suffering	扭曲的苦痛精华	扭曲的苦痛精A
	Cap		
	Skull Cap		
	Helm		
	Full Helm		
	Great Helm		
	Crown		
	Mask		
	Bone Helm		
	War Hat		
	Sallet		
	Casque		
	Basinet		
	Winged Helm		
	Grand Crown		
	Death Mask		
	Grim Helm		
	Shako		
	Hydraskull		
	Armet		
	Giant Conch		
	Spired Helm		
	Corona		
	Demonhead		
	Bone Visage		
	Circlet		
	Coronet		
	Tiara		
	Diadem		
	Jawbone Cap		
	Fanged Helm		
	Horned Helm		
	Assault Helmet		
	Avenger Guard		
	Jawbone Visor		
	Lion Helm		
	Range Mask		
	Savage Helmet		
	Slayer Guard		
	Carnage Helm		
	Fury Visor		
	Destroyer Helm		
	Conqueror Crown		
	Guardian Crown		
	Wolf Head		
	Hawk Helm		
	Antlers		
	Falcon Mask		
	Spirit Mask		
	Alpha Helm		
	Griffon Headdress		
	Hunter's Guise		
	Sacred Feathers		
	Totemic Mask		
	Blood Spirit		
	Sun Spirit		
	Earth Spirit		
	Sky Spirit		
	Dream Spirit		
	Leather Gloves		
	Heavy Gloves		
	Chain Gloves		
	Light Gauntlets		
	Gauntlets		
	Demonhide Gloves		
	Sharkskin Gloves		
	Heavy Bracers		
	Battle Gauntlets		
	War Gauntlets		
	Bramble Mitts		
	Vampirebone Gloves		
	Vambraces		
	Crusader Gauntlets		
	Ogre Gauntlets		
	Boots		
	Heavy Boots		
	Chain Boots		
	Light Plated Boots		
	Greaves		
	Demonhide Boots		
	Sharkskin Boots		
	Mesh Boots		
	Battle Boots		
	War Boots		
	Wyrmhide Boots		
	Scarabshell Boots		
	BoneWeave Boots		
	Mirrored Boots		
	Myrmidon Greaves		
	Sash		
	Light Belt		
	Belt		
	Heavy Belt		
	Plated Belt		
	Demonhide Sash		
	Sharkskin Belt		
	Mesh Belt		
	Battle Belt		
	War Belt		
	Spiderweb Sash		
	Vampirefang Belt		
	Mithril Coil		
	Troll Belt		
	Colossus Girdle		
	Quilted Armor		
	Leather Armor		
	Hard Leather Armor		
	Studded Leather		
	Ring Mail		
	Scale Mail		
	Chain Mail		
	Breast Plate		
	Splint Mail		
	Plate Mail		
	Field Mail		
	Gothic Plate		
	Full Plate Mail		
	Ancient Armor		
	Light Plate		
	Ghost Armor		
	Serpentskin Armor		
	Demonhide Armor		
	Trellised Armor		
	Linked Mail		
	Tigulated Mail		
	Mesh Armor		
	Cuirass		
	Russet Armor		
	Templar Coat		
	Sharktooth Armor		
	Embossed Plate		
	Chaos Armor		
	Ornate Plate		
	Mage Plate		
	Dusk Shroud		
	Wyrmhide		
	Scarab Husk		
	Wire Fleece		
	Diamond Mail		
	Loricated Mail		
	Boneweave		
	Great Hauberk		
	Balrog Skin		
	Hellforge Plate		
	Kraken Shell		
	Lacquered Plate		
	Shadow Plate		
	Sacred Armor		
	Archon Plate		
	Buckler		
	Small Shield		
	Large Shield		
	Kite Shield		
	Tower Shield		
	Gothic Shield		
	Bone Shield		
	Spiked Shield		
	Defender		
	Round Shield		
	Scutum		
	Dragon Shield		
	Pavise		
	Ancient Shield		
	Grim Shield		
	Barbed Shield		
	Heater		
	Luna		
	Hyperion		
	Monarch		
	Aegis		
	Ward		
	Troll Nest		
	Blade Barrier		
	Targe		
	Rondache		
	Heraldic Shield		
	Aerin Shield		
	Crown Shield		
	Akaran Targe		
	Akaran Rondache		
	Protector Shield		
	Gilded Shield		
	Royal Shield		
	Sacred Targe		
	Sacred Rondache		
	Kurast Shield		
	Zakarum Shield		
	Vortex Shield		
	Preserved Head		
	Zombie Head		
	Unraveller Head		
	Gargoyle Head		
	Demon Head		
	Mummified Trophy		
	Fetish Trophy		
	Sexton Trophy		
	Cantor Trophy		
	Hierophant Trophy		
	Minion Skull		
	Hellpawn Skull		
	Overseer Skull		
	Succubus Skull		
	Bloodlord Skull		
	Hand Axe		
	Axe		
	Double Axe		
	Military Pick		
	War Axe		
	Large Axe		
	Broad Axe		
	Battle Axe		
	Great Axe		
	Gaint Axe		
	Hatchet		
	Cleaver		
	Twin Axe		
	Crowbill		
	Naga		
	Military Axe		
	Bearded Axe		
	Tabar		
	Gothic Axe		
	Ancient Axe		
	Tomahawk		
	Small Crescent		
	Ettin Axe		
	War Spike		
	Berserker Axe		
	Feral Axe		
	Silver-Edged Axe		
	Decapitator		
	Champion Axe		
	Glorious Axe		
	Wand		
	Yew Wand		
	Bone Wand		
	Grim Wand		
	Burnt Wand		
	Petrified Wand		
	Tomb Wand		
	Grave Wand		
	Polished Wand		
	Ghost Wand		
	Lich Wand		
	Unearthed Wand		
	Club		
	Spiked Club		
	Mace		
	Morning Star		
	Flail		
	War Hammer		
	Maul		
	Great Maul		
	Cudgel		
	Barbed Club		
	Flanged Mace		
	Jagged Star		
	Knout		
	Battle Hammer		
	War Club		
	Martel De Fer		
	Truncheon		
	Tyrant Club		
	Reinforced Mace		
	Devil Star		
	Scourge		
	Legendary Mallet		
	Ogre Maul		
	Thunder Maul		
	Scepter		
	Grand Scepter		
	War Scepter		
	Rune Scepter		
	Holy Water Sprinkler		
	Divine Scepter		
	Mighty Scepter		
	Seraph Rod		
	Caduceus		
	Short Sword		
	Scimitar		
	Sabre		
	Falchion		
	Crystal Sword		
	Broad Sword		
	Long Sword		
	War Sword		
	Tow Handed Sword		
	Claymore		
	Giant Sword		
	Bastard Sword		
	Flamberge		
	Great Sword		
	Dagger		
	Dirk		
	Kris		
	Blade		
	Gladius		
	Cutlass		
	Shamshir		
	Tulwar		
	Dimensional Blade		
	Battle Sword		
	Rune Sword		
	Ancient Sword		
	Espandon		
	Dacian Falx		
	Tusk Sword		
	Gothic Sword		
	Zweihander		
	Executioner Sword		
	Poignard		
	Rondel		
	Cinquedeas		
	Stiletto		
	Falcata		
	Ataghan		
	Elegant Blade		
	Hydra Edge		
	Phase Blade		
	Conquest Sword		
	Cryptic Sword		
	Mythical Sword		
	Legend Sword		
	Highland Blade		
	Balrog Blade		
	Champion Sword		
	Colossus Sword		
	Colossus Blade		
	Bone Knife		
	Mithril Point		
	Fanged Knife		
	Legend Spike		
	Throwing Knife		
	Throwing Axe		
	Balanced Knife		
	Balanced Axe		
	Battle Dart		
	Francisca		
	War Dart		
	Hurlbat		
	Flying Knife		
	Flying Axe		
	Winged Knife		
	Winged Axe		
	Javelin		
	Pilum		
	Short Spear		
	Glaive		
	Throwing Spear		
	War Javelin		
	Great Pilum		
	Simbilan		
	Spiculum		
	Harpoon		
	Hyperion Javelin		
	Stygian Pilum		
	Balrog Spear		
	Ghost Glaive		
	Winged Harpoon		
	Spear		
	Trident		
	Brandistock		
	Spetum		
	Pike		
	Bardiche		
	Voulge		
	Scythe		
	Poleaxe		
	Halberd		
	War Scythe		
	War Spear		
	Fuscina		
	War Fork		
	Yari		
	Lance		
	Lochaber Axe		
	Bill		
	Battle Scythe		
	Partizan		
	Bec-de-Corbin		
	Grim Scythe		
	Hyperion Spear		
	Stygain Pike		
	Mancatcher		
	Ghost Spear		
	War Pike		
	Ogre Axe		
	Colossus Voulge		
	Thresher		
	Cryptic Axe		
	Great Poleaxe		
	Giant Thresher		
	Short Staff		
	Long Staff		
	Ganrled Staff		
	Battle Staff		
	War Staff		
	Jo Staff		
	Quarter Staff		
	Cedar Staff		
	Gothic Staff		
	Rune Staff		
	Walking Stick		
	Stalagmite		
	Elder Staff		
	Shillelagh		
	Archon Staff		
	Short Bow		
	Hunter's Bow		
	Long Bow		
	Composite Bow		
	Short Battle Bow		
	Long Battle Bow		
	Short War Bow		
	Long War Bow		
	Light Crossbow		
	Crossbow		
	Heavy Crossbow		
	Repeating Crossbow		
	Edge Bow		
	Razor Bow		
	Cedar Bow		
	Double Bow		
	Short Siege Bow		
	Large Siege Bow		
	Rune Bow		
	Gothic Bow		
	Arbalest		
	Siege Crossbow		
	Ballista		
	Chu-ko-Nu		
	Spider Bow		
	Blade Bow		
	Shadow Bow		
	Great Bow		
	Diamond Bow		
	Crusader Bow		
	Ward Bow		
	Hydra Bow		
	Pellet Bow		
	Gorgon Crossbow		
	Colossus Crossbow		
	Demon Crossbow		
	Rancid Gas Potion		
	Oil Potion		
	Choking Gas Potion		
	Exploding Potion		
	Strangling Gas Potion		
	Fulminating Potion		
	Decoy Gidbinn		
	The Gidbinn		
	Wirt's Leg		
	Horadric Malus		
	Hell Forge Hammer		
	Horadric Staff		
	Staff Of Kings		
	Khalim's Flail		
	Khalim's Will		
	Katar		
	Wrist Blade		
	Hatchet Hands		
	Cestus		
	Claws		
	Blade Talons		
	Scissors Katar		
	Quhab		
	Wrist Spike		
	Fascia		
	Hand Scythe		
	Greater Claws		
	Greater Talons		
	Scissors Quhab		
	Suwayyah		
	Wrist Sword		
	War Fist		
	Battle Cestus		
	Feral Claws		
	Runic Talons		
	Scissors Suwayyah		
	Eagle Orb		
	Sacred Globe		
	Smoked Sphere		
	Clasped Orb		
	Jared's Stone		
	Glowing Orb		
	Crystalline Globe		
	Cloudy Sphere		
	Sparkling Ball		
	Swirling Crystal		
	Heavenly Stone		
	Eldritch Orb		
	Demon Heart		
	Vortex Orb		
	Dimensional Shard		
	Stag Bow		
	Reflex Bow		
	Maiden Spear		
	Maiden Pike		
	Maiden Javelin		
	Ashwood Bow		
	Ceremonial Bow		
	Ceremonial Spear		
	Ceremonial Pike		
	Ceremonial Javelin		
	Matriarchal Bow		
	Grand Matron Bow		
	Matriarchal Spear		
	Matriarchal Pike		
	Matriarchal Javelin		
*=======================以下是属性名称(Property Name)			
	%+d Strength		
	%+d Energy		
	%+d Dexterity		
	%+d Vitality		
	Stat Point		
	Skill Point		
	Life		
	%+d Max Life		
	Mana		
	%+d Max Mana		
	Stamina		
	%+d Max Stamina		
	Level		
	Experience		
	Gold		
	Goldbank		
	%+d%% Enhanced Defense		
	%+d%% - %d%% Enhanced Damage		
	%+d%% Enhanced Min Damage		
	%+d Attack Rating		
	%+d%% Chance of Blocking		
	%+d Min 1-Handed Damage		
	%+d Max 1-Handed Damage		
	%+d Min 2-Handed Damage		
	%+d Max 2-Handed Damage		
	Damage %+d%% NV		
	Regenerate Mana %d%% NV		
	Regenerate Mana %+d%%		
	Heal Stemina %+d%%		
	Lastexp		
	Nextxp		
	%+d Defense		
	%+d Defense vs Missile		
	%+d Defense vs Melee		
	Damage Reduced By %+d		
	Magic Damage Reduced By %+d		
	Damage Reduced By %+d%%		
	%+d%% Magic Resist		
	%+d%% Max Magic Resist		
	%+d%% Fire Resist		
	%+d%% Max Fire Resist		
	%+d%% Lightning Resist		
	%+d%% Max Lightning Resist		
	%+d%% Cold Resist		
	%+d%% Max Cold Resist		
	%+d%% Poison Resist		
	%+d%% Max Poison Resist		
	Damageaure		
	%+d - %d Fire Damage		
	%+d Max Fire Damage		
	%+d - %d Lightning Damage		
	%+d Max Lightning Damage		
	%+d - %d Magic Damage		
	%+d Max Magic Damage		
	%+d - %d Cold Damage Freezing %d sec		
	%+d Max Cold Damage		
	%+d Cold Length		
	%+d - %d Poison Damage Over %d sec		
	%+d Max Poison Damage		
	%+d Poison Length		
	%+d%% Life Stolen per Hit Min		
	%+d%% Life Stolen per Hit Max		
	%+d%% Mana Stolen per Hit Min		
	%+d%% Mana Stolen per Hit Max		
	Stamina Drain Min		
	Stamina Drain Max		
	Stun Length		
	Run/Walk Speed %+d%% NV		
	Attack Speed %+d%% NV		
	Other Animrate		
	Quantity		
	Value %+d		
	%+d Durability		
	%+d Max Durability		
	%+d Replenish Life		
	Increase Max Durability %+d%%		
	Increase Max Life %+d%%		
	Increase Max Mana %+d%%		
	Attacker Takes Damage of %+d		
	%+d%% Extra Gold From Monsters		
	%+d%% Better Chance of Getting Magic Items		
	Knock Back %+d		
	Time Duration %+d		
	%+d %s Skill		
	Unsentparaml		
	%+d%% Experience Gained		
	%+d Life After Each Kill		
	Reduced Prices %+d%%		
	Double Herb Duration		
	%+d Light Radius		
	Light Color NV %d		
	Requirements %+d%%		
	%+d Item Level Require		
	%+d%% Increase Attack Speed		
	Item Level Require %+d%%		
	Last Block Frame		
	%+d%% Faster Run/Walk		
	%+d to %s		
	Change Character State to %s		
	%+d%% Faster Hit Recovery Rate		
	Monster Player Count		
	Poison Override		
	%+d%% Faster Block Rate		
	Bypass Undead		
	Bypass Demons		
	%+d%% Faster Cast Rate		
	Bypass Beast		
	%+d to %s (%s only)		
	Slain Monsters Rest In Peace %+d		
	Curse Resist %+d		
	Poison Length Reduced by %+d%%		
	Damage %+d		
	Hit Causes Monster Flee %+d%%		
	Hit Blinds Target %+d		
	-%d%% Damage Mana		
	Ignore Target Defense		
	-%d%% Target Defense		
	Prevent Monster Heal %+d		
	Half Freeze Duration		
	%+d%% Bonus Attack Rating		
	%+d Monster Defense Per Hit		
	%+d%% Damage to Demons		
	%+d%% Damage to Undead		
	%+d Attack Rating vs Demons		
	%+d Attack Rating vs Undead		
	Throwable		
	%+d Fire Skills %d		
	%+d All Skills		
	Attacker Takes Lightning Damage of %+d		
	Iron Maiden Level		
	Life Tap Level		
	Thorns Percent		
	Bone Armor		
	Bone Armor Max		
	Freezes Target %+d		
	%+d%% Chance of Open Wounds		
	%+d%% Chance of Crushing Blow		
	%+d Kick Damage		
	%+d Mana After Each Kill		
	%+d Life After Each Demon Kill		
	Extra Blood %d		
	%+d%% Chance of Deadly Strike		
	Fire Absorb %+d%%		
	%+d File Absorb		
	Lightning Absorb %+d%%		
	%+d Lightning Absorb		
	Magic Absorb %+d%%		
	%+d Magic Absorb		
	Cold Absorb %+d%%		
	%+d Cold Absorb		
	Slows Target by %+d%%		
	Level %+d %s Aura When Equipped		
	Indestructible		
	Cannot Be Frozen		
	%+d%% Slower Stamina Drain		
	%+d%% Chance of Reanimate as %s		
	%+d%% Chance of Piercing Attack		
	Fires Magic Arrows or Bolts %+d		
	Fires Explosive Arrows or Bolts %+d		
	%+d to Min Throw Damage NV		
	%+d to Max Throw Damage NV		
	Uncoded		
	Uncoded		
	Uncoded		
	Uncoded		
	Uncoded		
	Uncoded		
	Uncoded		
	Uncoded		
	Uncoded		
	Uncoded		
	Uncoded		
	Uncoded		
	Uncoded		
	Uncoded		
	Uncoded		
	Uncoded		
	Uncoded		
	Uncoded		
	%+d%% to Attack Rating vs %s		
	%+d%% to Damage vs %s		
	Fade %d		
	Armor Override		
	Unused		
	Unused		
	Unused		
	Unused		
	Unused		
	%+d %s (%s only)		
	Unused		
	Unused		
	Unused		
	Unused		
	Unused		
	Add %+d Sockets		
	%+d%% Chance to Cast Level %d %s When Attack		
	%+d%% Chance to Cast Level %d %s When Kill		
	%+d%% Chance to Cast Level %d %s When Death		
	%+d%% Chance to Cast Level %d %s When Striking		
	%+d%% Chance to Cast Level %d %s When Levelup		
	Unused		
	%+d%% Chance to Cast Level %+d %s When Struck		
	Unused		
	Unused		
	Level %+d %s (%d/%d Charges)		
	Unused		
	Unused		
	Unused		
	Unused		
	Unused		
	Unused		
	Unused		
	Unused		
	Unused		
	%+g Defence per Level		
	%+g Enhanced Defence per Level		
	%+g Life per Level		
	%+g Mana per Level		
	%+g Max Damage per Level		
	%+g Enhanced Max Damage per Level		
	%+g Strength per Level		
	%+g Dexterity per Level		
	%+g Energy per Level		
	%+g Vitality per Level		
	%+g Attack Rating per Level		
	%+g%% Bonus to Attack Rating per Level		
	%+g Max Cold Damage per Level		
	%+g Max Fire Damage per Level		
	%+g Max Lightning Damage per Level		
	%+g Max Poison Damage per Level		
	Cold Resist %+g%% per Level		
	Fire Resist %+g%% per Level		
	Lightning Resist %+g%% per Level		
	Poison Resist %+g%% per Level		
	%+g Cold Absorb per Level		
	%+g Fire Absorb per Level		
	%+g Lightning Absorb per Level		
	%+g Poison Absorb per Level		
	Attacker Takes Damage of %+g per Level		
	%+g%% Extra Gold from Monsters per Level		
	%+g%% Better Chance of Getting Magic Items per Level		
	Heal Stamina Plus %+g%% per Level		
	%+g Max Stamina per Level		
	%+g%% Damage to Demons per Level		
	%+g%% Damage to Undead per Level		
	%+g to Attack Rating vs Demons per Level		
	%+g to Attack Rating vs Undead per Level		
	%+g%% Chance of Crushing Blow per Level		
	%+g%% Chance of Open Wounds per Level		
	%+g Kick Damage per Level		
	%+g%% Chance of Deadly Strike per Level		
	Find Gems per Level		
	Repairs 1 Durability in %d Seconds		
	Replenishes 1 Quantity in %d Seconds		
	Increased Stack Size %+d		
	Uncoded		
	Uncoded		
	Uncoded		
	Uncoded		
	Uncoded		
	Uncoded		
	Uncoded		
	Uncoded		
	Uncoded		
	Uncoded		
	Uncoded		
	Uncoded		
	Uncoded		
	%+d - %d Defense (Increases %s)		
	%+d - %d Enhanced Defense (Increases %s)		
	%+d - %d Life (Increases %s)		
	%+d - %d Mana (Increases %s)		
	%+d - %d Max Damage (Increases %s)		
	%+d - %d Enhanced Max Damage (Increases %s)		
	%+d - %d Strength (Increases %s)		
	%+d - %d Dexterity (Increases %s)		
	%+d - %d Energy (Increases %s)		
	%+d - %d Vitality (Increases %s)		
	%+d - %d Attack Rating (Increases %s)		
	%+d - %d Enhanced Attack Rating (Increases %s)		
	%+d - %d Max Cold Damage (Increases %s)		
	%+d - %d Max Fire Damage (Increases %s)		
	%+d - %d Max Lightning Damage (Increases %s)		
	%+d - %d Max Poison Damage (Increases %s)		
	%+d%% - %d%% Cold Resist (Increases %s)		
	%+d%% - %d%% Fire Resist (Increases %s)		
	%+d%% - %d%% Lightning Resist (Increases %s)		
	%+d%% - %d%% Poison Resist (Increases %s)		
	%+d - %d Cold Absorb (Increases %s)		
	%+d - %d Fire Absorb (Increases %s)		
	%+d - %d Lightning Absorb (Increases %s)		
	%+d - %d Poison Absorb (Increases %s)		
	%+d%% - %d%% Extra Gold from Monsters (Increases %s)		
	%+d%% - %d%% Better Chance of Getting Magic Items (Increases %s)		
	Heal Stamina Plus %+d - %d%% (Increases %s)		
	%+d - %d Stamina (Increases %s)		
	%+d%% - %d%% Damage to Demons (Increases %s)		
	%+d%% - %d%% Damage to Undead (Increases %s)		
	%+d - %d Attack Rating vs Demons (Increases %s)		
	%+d - %d Attack Rating vs Undead (Increases %s)		
	%+d%% - %d%% Chance of Crushing Blow (Increases %s)		
	%+d%% - %d%% Chance of Open Wounds (Increases %s)		
	%+d - %d Kick Damage (Increases %s)		
	%+d - %d Chance of  Deadly Strike (Increases %s)		
	Item Find Gems (by time)		
	%+d%% Enemy Cold Resist		
	%+d%% Enemy Fire Resist		
	%+d%% Enemy Lightning Resist		
	%+d%% Enemy Poison Resist		
	Item Damage vs Monster		
	Item Damage Percent vs Monster		
	Item Tohit vs Monster		
	Item Tohit Percent vs Monster		
	Item AC vs Monster		
	Item AC Percent vs Monster		
	Fire Length		
	Burning Min		
	Burning Max		
	Progressive Damage		
	Progressive Steal		
	Progressive Other		
	Progressive Fire		
	Progressive Cold		
	Progressive Lightning		
	Item Extra Charges %+d		
	Progressive Tohit		
	Poison Count		
	Damage Frame Rate		
	Pierce IDX		
	%+d%% Fire Skill Damage		
	%+d%% Lightning Skill Damage		
	%+d%% Cold Skill Damage		
	%+d%% Poison Skill Damage		
	%+d%% Enemy Fire Resist		
	%+d%% Enemy Lightning Resist		
	%+d%% Enemy Cold Resist		
	%+d%% Enemy Poison Resist		
	Passive Critical Strike %d		
	Passive Dodge %d		
	Passive Avoid %d		
	Passive Evade %d		
	Passive Warmth %d		
	Passive Mastery Melee TH %d		
	Passive Mastery Melee Damage %d		
	Passive Mastery Melee Crit %d		
	Passive Mastery Throw TH %d		
	Passive Mastery Throw Damage %d		
	Passive Mastery Throw Crit %d		
	Passive Weapon Block %d		
	Passive Summon Resist %d		
	Modifier List Skill		
	Modifier List Level		
	Last Sent HP PCT		
	Source Unit Type		
	Source Unit ID		
	Short Paraml		
	Quest Item Difficulty %d		
	Passive Magic Mastery %d		
	Passive Magic Pierce %d		
*=======================以下是怪物名称(Monster Names)			
	Skeleton		
	Returned		
	BoneWarrior		
	BurningDead		
	Horror		
	Zombie		
	HungryDead		
	Ghoul		
	DrownedCarcass		
	PlagueBearer		
	Afflicted		
	Tainted		
	Misshapen		
	Disfigured		
	Damned		
	FoulCrow		
	BloodHawk		
	BlackRaptor		
	CloudStalker		
	Fallen		
	Carver		
	Devilkin		
	DarkOne		
	WarpedFallen		
	Brute		
	Yeti		
	Crusher		
	WailingBeast		
	GargantuanBeast		
	SandRaider		
	Marauder		
	Invader		
	Infidel		
	Assailant		
	unused		
	unused		
	unused		
	unused		
	Ghost		
	Wraith		
	Specter		
	Apparition		
	DarkShape		
	DarkHunter		
	VileHunter		
	DarkStalker		
	BlackRogue		
	FleshHunter		
	DuneBeast		
	RockDweller		
	JungleHunter		
	DoomApe		
	TempleGuard		
	MoonClan		
	NightClan		
	BloodClan		
	HellClan		
	DeathClan		
	FallenShaman		
	CarverShaman		
	DevilkinShaman		
	DarkShaman		
	WarpedShaman		
	QuillRat		
	SpikeFiend		
	ThornBeast		
	RazorSpine		
	JungleUrchin		
	SandMaggot		
	RockWorm		
	Devourer		
	GiantLamprey		
	WorldKiller		
	TombViper		
	ClawViper		
	Salamander		
	PitViper		
	SerpentMagus		
	SandLeaper		
	CaveLeaper		
	TombCreeper		
	TreeLurker		
	RazorPitDemon		
	Huntress		
	SaberCat		
	NightTiger		
	HellCat		
	Itchies		
	BlackLocusts		
	PlagueBugs		
	HellSwarm		
	DungSoldier		
	SandWarrior		
	Scarab		
	SteelWeevil		
	AlbinoRoach		
	DriedCorpse		
	Decayed		
	Embalmed		
	PreservedDead		
	Cadaver		
	HollowOne		
	Guardian		
	Unraveler		
	Horadrim Ancient		
	Baal Subject Mummy		
	unused		
	unused		
	unused		
	unused		
	CarrionBird		
	UndeadScavenger		
	HellBuzzard		
	WingedNightmare		
	Sucker		
	Feeder		
	BloodHook		
	BloodWing		
	Gloam		
	SwampGhost		
	BurningSoul		
	BlackSoul		
	Arach		
	SandFisher		
	PoisonSpinner		
	FlameSpider		
	SpiderMagus		
	ThornedHulk		
	BrambleHulk		
	Thrasher		
	Spikefist		
	GhoulLord		
	NightLord		
	DarkLord		
	BloodLord		
	Banished		
	DesertWing		
	Fiend		
	Gloombat		
	BloodDiver		
	DarkFamiliar		
	RatMan		
	Fetish		
	Flayer		
	SoulKiller		
	StygianDoll		
	DeckardCain		
	Gheed		
	Akara		
	dummy		
	Kashya		
	dummy		
	Dummy		
	Dummy		
	Charsi		
	Warriv		
	Andariel		
	dummy		
	dummy		
	dummy		
	DarkRanger		
	VileArcher		
	DarkArcher		
	BlackArcher		
	FleshArcher		
	DarkSpearwoman		
	VileLancer		
	DarkLancer		
	BlackLancer		
	FleshLancer		
	SkeletonArcher		
	ReturnedArcher		
	BoneArcher		
	BurningDeadArcher		
	HorrorArcher		
	Warriv		
	Atma		
	Drognan		
	Fara		
	dummy		
	SandMaggotYoung		
	RockWormYoung		
	DevourerYoung		
	GiantLampreyYoung		
	WorldKillerYoung		
	dummy		
	Blunderbore		
	Gorbelly		
	Mauler		
	Urdar		
	SandMaggotEgg		
	RockWormEgg		
	DevourerEgg		
	GiantLampreyEgg		
	WorldKillerEgg		
	dummy		
	Dummy		
	dummy		
	Greiz		
	Elzix		
	Geglash		
	Jerhyn		
	Lysander		
	Dummy		
	dummy		
	dummy		
	FoulCrowNest		
	BloodHawkNest		
	BlackVultureNest		
	CloudStalkerNest		
	Meshif		
	Duriel		
	Undead RatMan		
	Undead Fetish		
	Undead Flayer		
	Undead SoulKiller		
	Undead StygianDoll		
	unused		
	unused		
	unused		
	unused		
	unused		
	unused		
	unused		
	unused		
	unused		
	unused		
	Maggot		
	MummyGenerator		
	Radament		
	unused		
	unused		
	unused		
	unused		
	FlyingScimitar		
	Zakarumite		
	Faithful		
	Zealot		
	Sexton		
	Cantor		
	Heirophant		
	Heirophant		
	Mephisto		
	Diablo		
	DeckardCain		
	DeckardCain		
	DeckardCain		
	Swamp Dweller		
	Bog Creature		
	Slime Prince		
	Summoner		
	tyrael		
	asheara		
	hratli		
	alkor		
	ormus		
	izual		
	halbu		
	WaterWatcherLimb		
	RiverStalkerLimb		
	StygianWatcherLimb		
	WaterWatcherHead		
	RiverStalkerHead		
	StygianWatcherHead		
	meshif		
	DeckardCain		
	navi		
	Bloodraven		
	Dummy		
	Dummy		
	RogueScout		
	Dummy		
	Dummy		
	GargoyleTrap		
	ReturnedMage		
	BoneMage		
	BurningDeadMage		
	HorrorMage		
	RatManShaman		
	FetishShaman		
	FlayerShaman		
	SoulKillerShaman		
	StygianDollShaman		
	larva		
	SandMaggotQueen		
	RockWormQueen		
	DevourerQueen		
	GiantLampreyQueen		
	WorldKillerQueen		
	ClayGolem		
	BloodGolem		
	IronGolem		
	FireGolem		
	Dummy		
	Dummy		
	NightMarauder		
	Dummy		
	Natalya		
	FleshSpawner		
	StygianHag		
	Grotesque		
	FleshBeast		
	StygianDog		
	GrotesqueWyrm		
	Groper		
	Strangler		
	StormCaster		
	Corpulent		
	CorpseSpitter		
	MawFiend		
	DoomKnight		
	AbyssKnight		
	OblivionKnight		
	QuillBear		
	SpikeGiant		
	ThornBrute		
	RazorBeast		
	GiantUrchin		
	Dummy		
	Dummy		
	Dummy		
	Dummy		
	Dummy		
	Dummy		
	Dummy		
	Dummy		
	a trap		
	a trap		
	a trap		
	a trap		
	a trap		
	Kaelan		
	Dummy		
	Diablo		
	SuckerNest		
	FeederNest		
	BloodHookNest		
	BloodWingNest		
	Guard		
	Dummy		
	Dummy		
	Dummy		
	Dummy		
	Dummy		
	Dummy		
	Council Member		
	Council Member		
	Council Member		
	Turret		
	Turret		
	Turret		
	Hydra		
	Hydra		
	Hydra		
	a trap		
	Dummy		
	Dopplezon		
	Valkyrie		
	Dummy		
	Iron Wolf		
	Balrog		
	PitLord		
	VenomLord		
	NecroSkeleton		
	NecroMage		
	Griswold		
	compellingorb		
	tyrael		
	youngdiablo		
	a trap		
	Dummy		
	LightningSpire		
	FireTower		
	Slinger		
	SpearCat		
	NightSlinger		
	HellSlinger		
	Dummy		
	Dummy		
	ReturnedMage		
	BoneMage		
	BaalColdMage		
	HorrorMage		
	ReturnedMage		
	BoneMage		
	BurningDeadMage		
	HorrorMage		
	ReturnedMage		
	BoneMage		
	BurningDeadMage		
	HorrorMage		
	Hell Bovine		
	Dummy		
	Dummy		
	SpearCat		
	NightSlinger		
	RatMan		
	Fetish		
	Flayer		
	SoulKiller		
	StygianDoll		
	Dummy		
	The Smith		
	TrappedSoul		
	TrappedSoul		
	Jamella		
	Izual		
	RatMan		
	Malachai		
	The Feature Creep		
	Wake of Destruction		
	Charged Bolt Sentry		
	Lightning Sentry		
	Blade Creeper		
	Invis Pet		
	Inferno Sentry		
	Death Sentry		
	Shadow Warrior		
	Shadow Master		
	Druid Hawk		
	Druid Spirit Wolf		
	Druid Fenris		
	Spirit of Barbs		
	Heart of Wolverine		
	Oak Sage		
	Druid Plague Poppy		
	Druid Cycle of Life		
	Vine Creature		
	Druid Bear		
	Eagle		
	Wolf		
	Bear		
	Barricade Door		
	Barricade Door		
	Prison Door		
	Barricade Tower		
	RotWalker		
	ReanimatedHorde		
	ProwlingDead		
	UnholyCorpse		
	DefiledWarrior		
	Siege Beast		
	CrushBiest		
	BloodBringer		
	GoreBearer		
	DeamonSteed		
	SnowYeti1		
	SnowYeti2		
	SnowYeti3		
	SnowYeti4		
	WolfRider1		
	WolfRider2		
	WolfRider3		
	Minionexp		
	Slayerexp		
	IceBoar		
	FireBoar		
	HellSpawn		
	IceSpawn		
	GreaterHellSpawn		
	GreaterIceSpawn		
	FanaticMinion		
	BerserkSlayer		
	ConsumedIceBoar		
	ConsumedFireBoar		
	FrenziedHellSpawn		
	FrenziedIceSpawn		
	InsaneHellSpawn		
	InsaneIceSpawn		
	Succubusexp		
	VileTemptress		
	StygianHarlot		
	Hell Temptress		
	Blood Temptress		
	Dominus		
	VileWitch		
	StygianFury		
	Blood Witch		
	Hell Witch		
	OverSeer		
	Lasher		
	OverLord		
	BloodBoss		
	HellWhip		
	MinionSpawner		
	MinionSlayerSpawner		
	MinionIce/fireBoarSpawner		
	MinionIce/fireBoarSpawner		
	Minionice/hellSpawnSpawner		
	MinionIce/fireBoarSpawner		
	MinionIce/fireBoarSpawner		
	Minionice/hellSpawnSpawner		
	Imp1		
	Imp2		
	Imp3		
	Imp4		
	Imp5		
	CatapultS		
	CatapultE		
	CatapultSiege		
	CatapultW		
	Frozen Horror1		
	Frozen Horror2		
	Frozen Horror3		
	Frozen Horror4		
	Frozen Horror5		
	Blood Lord1		
	Blood Lord2		
	Blood Lord3		
	Blood Lord4		
	Blood Lord5		
	Larzuk		
	Drehya		
	Malah		
	Nihlathak Town		
	Qual-Kehk		
	Catapult Spotter S		
	Catapult Spotter E		
	Catapult Spotter Siege		
	Catapult Spotter W		
	DeckardCain		
	tyrael		
	Act 5 Combatant		
	Act 5 Combatant		
	Barricade Wall Right		
	Barricade Wall Left		
	Nihlathak		
	Drehya		
	Evil hut		
	Death Mauler1		
	Death Mauler2		
	Death Mauler3		
	Death Mauler4		
	Death Mauler5		
	POW		
	Act 5 Townguard		
	Act 5 Townguard		
	Ancient Statue 1		
	Ancient Statue 2		
	Ancient Statue 3		
	Ancient Barbarian 1		
	Ancient Barbarian 2		
	Ancient Barbarian 3		
	Baal Throne		
	Baal Crab		
	Baal Taunt		
	Putrid Defiler1		
	Putrid Defiler2		
	Putrid Defiler3		
	Putrid Defiler4		
	Putrid Defiler5		
	Pain Worm1		
	Pain Worm2		
	Pain Worm3		
	Pain Worm4		
	Pain Worm5		
	Bunny		
	Council Member		
	VenomLord		
	Baal Crab to Stairs		
	Act 5 Hireling 1hs		
	Act 5 Hireling 2hs		
	Baal Tentacle		
	Baal Tentacle		
	Baal Tentacle		
	Baal Tentacle		
	Baal Tentacle		
	Injured Barbarian 1		
	Injured Barbarian 2		
	Injured Barbarian 3		
	Baal Crab Clone		
	Baals Minion		
	Baals Minion		
	Baals Minion		
	Worldstone Effect		
	BurningDeadArcher		
	BoneArcher		
	BurningDeadArcher		
	ReturnedArcher		
	HorrorArcher		
	Afflicted		
	Tainted		
	Misshapen		
	Disfigured		
	Damned		
	MoonClan		
	NightClan		
	HellClan		
	BloodClan		
	DeathClan		
	FoulCrow		
	BloodHawk		
	BlackRaptor		
	CloudStalker		
	ClawViper		
	PitViper		
	Salamander		
	TombViper		
	SerpentMagus		
	Marauder		
	Infidel		
	SandRaider		
	Invader		
	Assailant		
	Death Mauler1		
	QuillRat		
	SpikeFiend		
	RazorSpine		
	CarrionBird		
	ThornedHulk		
	Slinger		
	Slinger		
	Slinger		
	VileArcher		
	DarkArcher		
	VileLancer		
	DarkLancer		
	BlackLancer		
	Blunderbore		
	Mauler		
	ReturnedMage		
	BurningDeadMage		
	ReturnedMage		
	HorrorMage		
	BoneMage		
	HorrorMage		
	HorrorMage		
	Huntress		
	SaberCat		
	CaveLeaper		
	TombCreeper		
	Ghost		
	Wraith		
	Specter		
	Succubusexp		
	Hell Temptress		
	Dominus		
	Hell Witch		
	VileWitch		
	Gloam		
	BlackSoul		
	BurningSoul		
	Carver		
	Devilkin		
	DarkOne		
	CarverShaman		
	DevilkinShaman		
	DarkShaman		
	BoneWarrior		
	Returned		
	Gloombat		
	Fiend		
	Blood Lord1		
	Blood Lord4		
	Scarab		
	SteelWeevil		
	Flayer		
	StygianDoll		
	SoulKiller		
	Flayer		
	StygianDoll		
	SoulKiller		
	FlayerShaman		
	StygianDollShaman		
	SoulKillerShaman		
	TempleGuard		
	TempleGuard		
	Guardian		
	Unraveler		
	Horadrim Ancient		
	Horadrim Ancient		
	Zealot		
	Zealot		
	Heirophant		
	Heirophant		
	Grotesque		
	FleshSpawner		
	GrotesqueWyrm		
	FleshBeast		
	WorldKiller		
	WorldKillerYoung		
	WorldKillerEgg		
	Slayerexp		
	HellSpawn		
	GreaterHellSpawn		
	Arach		
	Balrog		
	PitLord		
	Imp1		
	Imp4		
	Undead StygianDoll		
	Undead SoulKiller		
	Strangler		
	StormCaster		
	MawFiend		
	BloodLord		
	GhoulLord		
	DarkLord		
	UnholyCorpse		
	DoomKnight		
	DoomKnight		
	OblivionKnight		
	OblivionKnight		
	Cadaver		
*=======================以下是魔法前缀(Magic Prefix)			
0			
1			
2	Sturdy		
3	Strong		
4	Glorious		
5	Blessed		
6	Saintly		
7	Holy		
8	Devious		
9	Fortified		
10			
11			
12			
13	Jagged		
14	Deadly		
15	Vicious		
16	Brutal		
17	Massive		
18	Savage		
19	Merciless		
20	Vulpine		
21			
22			
23			
24			
25	Tireless		
26	Rugged		
27	Bronze		
28	Iron		
29	Steel		
30	Silver		
31			
32	Gold		
33	Platinum		
34	Meteoric		
35	Sharp		
36	Fine		
37	Warrior's		
38	Soldier's		
39	Knight's		
40	Lord's		
41	King's		
42	Howling		
43	Fortuitous		
44			
45			
46			
47			
48			
49	Glimmering		
50	Glowing		
51			
52			
53	Lizard's		
54			
55	Snake's		
56	Serpent's		
57	Serpent's		
58	Drake's		
59	Dragon's		
60	Dragon's		
61	Wyrm's		
62			
63			
64	Prismatic		
65	Prismatic		
66	Azure		
67	Lapis		
68	Lapis		
69	Cobalt		
70	Cobalt		
71			
72	Sapphire		
73			
74			
75	Crimson		
76	Burgundy		
77	Burgundy		
78	Garnet		
79	Garnet		
80			
81	Ruby		
82			
83			
84	Ocher		
85	Tangerine		
86	Tangerine		
87	Coral		
88	Coral		
89			
90	Amber		
91			
92			
93	Beryl		
94	Jade		
95	Jade		
96	Viridian		
97	Viridian		
98			
99	Emerald		
100			
	Fletcher's		
	Archer's		
	Archer's		
	Monk's		
	Priest's		
	Priest's		
	Summoner's		
	Necromancer's		
	Necromancer's		
	Angel's		
	Arch-Angel's		
	Arch-Angel's		
	Slayer's		
	Berserker's		
	Berserker's		
116			
117			
	Triumphant		
	Stout		
	Stout		
	Stout		
	Burly		
	Burly		
	Burly		
	Stalwart		
	Stalwart		
	Stalwart		
	Stout		
	Stout		
	Stout		
	Burly		
	Burly		
	Stalwart		
	Stalwart		
	Stout		
	Stout		
	Burly		
	Stalwart		
	Blanched		
	Eburin		
	Bone		
	Ivory		
	Sturdy		
	Sturdy		
	Strong		
	Glorious		
	Blessed		
	Saintly		
	Holy		
	Godly		
	Devious		
	Blank		
	Null		
	Antimagic		
	Red		
	Red		
	Sanguinary		
	Sanguinary		
	Bloody		
	Red		
	Sanguinary		
	Bloody		
	Red		
	Sanguinary		
	Bloody		
	Scarlet		
	Crimson		
	Jagged		
	Jagged		
	Jagged		
	Forked		
	Forked		
	Serrated		
	Serrated		
	Jagged		
	Jagged		
	Forked		
	Forked		
	Serrated		
	Jagged		
	Forked		
	Serrated		
	Carbuncle		
	Carmine		
	Vermillion		
	Jagged		
	Deadly		
	Vicious		
	Brutal		
	Massive		
	Savage		
	Merciless		
	Ferocious		
	Cruel		
	Cinnabar		
	Rusty		
	Realgar		
	Ruby		
	Vulpine		
	Dun		
	Tireless		
	Tireless		
	Brown		
	Rugged		
	Rugged		
	Rugged		
	Rugged		
	Rugged		
	Rugged		
	Rugged		
	Rugged		
	Rugged		
	Rugged		
	Rugged		
	Vigorous		
	Chestnut		
	Maroon		
	Bronze		
	Bronze		
	Bronze		
	Iron		
	Iron		
	Iron		
	Steel		
	Steel		
	Steel		
	Bronze		
	Bronze		
	Bronze		
	Iron		
	Iron		
	Steel		
	Steel		
	Bronze		
	Bronze		
	Iron		
	Steel		
	Bronze		
	Iron		
	Steel		
	Silver		
	Gold		
	Platinum		
	Meteoric		
	Strange		
	Weird		
	Nickel		
	Tin		
	Silver		
	Argent		
	Fine		
	Fine		
	Sharp		
	Fine		
	Sharp		
	Fine		
	Sharp		
	Fine		
	Warrior's		
	Soldier's		
	Knight's		
	Lord's		
	King's		
	Master's		
	Grandmaster's		
	Glimmering		
	Glowing		
	Bright		
	Screaming		
	Howling		
	Wailing		
	Screaming		
	Howling		
	Wailing		
	Lucky		
	Lucky		
	Lucky		
	Lucky		
	Lucky		
	Lucky		
	Felicitous		
	Fortuitous		
	Emerald		
	Lizard's		
	Lizard's		
	Lizard's		
	Snake's		
	Snake's		
	Snake's		
	Serpent's		
	Serpent's		
	Serpent's		
	Lizard's		
	Lizard's		
	Lizard's		
	Snake's		
	Snake's		
	Serpent's		
	Serpent's		
	Lizard's		
	Lizard's		
	Snake's		
	Serpent's		
	Lizard's		
	Snake's		
	Serpent's		
	Serpent's		
	Drake's		
	Dragon's		
	Dragon's		
	Wyrm's		
	Great Wyrm's		
	Bahamut's		
	Zircon		
	Jacinth		
	Turquoise		
	Shimmering		
	Shimmering		
	Shimmering		
	Shimmering		
	Shimmering		
	Shimmering		
	Shimmering		
	Rainbow		
	Scintillating		
	Prismatic		
	Chromatic		
	Shimmering		
	Rainbow		
	Scintillating		
	Prismatic		
	Chromatic		
	Shimmering		
	Rainbow		
	Scintillating		
	Shimmering		
	Scintillating		
	Azure		
	Lapis		
	Cobalt		
	Sapphire		
	Azure		
	Lapis		
	Cobalt		
	Sapphire		
	Azure		
	Lapis		
	Cobalt		
	Sapphire		
	Azure		
	Lapis		
	Lapis		
	Cobalt		
	Cobalt		
	Sapphire		
	Lapis Lazuli		
	Sapphire		
	Crimson		
	Russet		
	Garnet		
	Ruby		
	Crimson		
	Russet		
	Garnet		
	Ruby		
	Crimson		
	Russet		
	Garnet		
	Ruby		
	Russet		
	Russet		
	Garnet		
	Garnet		
	Ruby		
	Garnet		
	Ruby		
	Tangerine		
	Ocher		
	Coral		
	Amber		
	Tangerine		
	Ocher		
	Coral		
	Amber		
	Tangerine		
	Ocher		
	Coral		
	Amber		
	Tangerine		
	Ocher		
	Ocher		
	Coral		
	Coral		
	Amber		
	Camphor		
	Ambergris		
	Beryl		
	Viridian		
	Jade		
	Emerald		
	Beryl		
	Viridian		
	Jade		
	Emerald		
	Beryl		
	Viridian		
	Jade		
	Emerald		
	Beryl		
	Viridian		
	Viridian		
	Jade		
	Jade		
	Emerald		
	Beryl		
	Jade		
	Triumphant		
	Victorious		
	Aureolin		
	Mechanist's		
	Artificer's		
	Jeweler's		
	Assamic		
	Arcadian		
	Unearthly		
	Astral		
	Elysian		
	Celestial		
	Diamond		
	Fletcher's		
	Acrobat's		
	Harpoonist's		
	Fletcher's		
	Bowyer's		
	Archer's		
	Acrobat's		
	Gymnast's		
	Athlete's		
	Harpoonist's		
	Spearmaiden's		
	Lancer's		
	Burning		
	Sparking		
	Chilling		
	Burning		
	Blazing		
	Volcanic		
	Sparking		
	Charged		
	Powered		
	Chilling		
	Freezing		
	Glacial		
	Hexing		
	Fungal		
	Graverobber's		
	Hexing		
	Blighting		
	Accursed		
	Fungal		
	Noxious		
	Venomous		
	Graverobber's		
	Vodoun		
	Golemlord's		
	Lion Branded		
	Captain's		
	Preserver's		
	Lion Branded		
	Hawk Branded		
	Rose Branded		
	Captain's		
	Commander's		
	Marshal's		
	Preserver's		
	Warder's		
	Guardian's		
	Expert's		
	Fanatic		
	Sounding		
	Expert's		
	Veteran's		
	Master's		
	Fanatic		
	Raging		
	Furious		
	Sounding		
	Resonant		
	Echoing		
	Trainer's		
	Spiritual		
	Nature's		
	Trainer's		
	Caretaker's		
	Keeper's		
	Spiritual		
	Feral		
	Communal		
	Nature's		
	Terra's		
	Gaea's		
	Entrapping		
	Mentalist's		
	Shogukusha's		
	Entrapping		
	Trickster's		
	Cunning		
	Mentalist's		
	Psychic		
	Shadow		
	Shogukusha's		
	Sensei's		
	Kenshi's		
	Miocene		
	Miocene		
	Oligocene		
	Oligocene		
	Eocene		
	Eocene		
	Paleocene		
	Paleocene		
	Knave's		
	Jack's		
	Jester's		
	Joker's		
	Trump		
	Loud		
	Calling		
	Yelling		
	Shouting		
	Gritty		
	Paradox		
	Paradox		
	Robineye		
	Sparroweye		
	Falconeye		
	Hawkeye		
	Eagleeye		
	Visionary		
	Mnemonic		
	Snowflake		
	Shivering		
	Boreal		
	Hibernal		
	Ember		
	Smoldering		
	Smoking		
	Flaming		
	Scorching		
	Static		
	Glowing		
	Buzzing		
	Arcing		
	Shocking		
	Septic		
	Envenomed		
	Corosive		
	Toxic		
	Pestilent		
	Maiden's		
	Valkyrie's		
	Maiden's		
	Valkyrie's		
	Monk's		
	Priest's		
	Monk's		
	Priest's		
	Monk's		
	Priest's		
	Summoner's		
	Necromancer's		
	Summoner's		
	Necromancer's		
	Angel's		
	Arch-Angel's		
	Angel's		
	Arch-Angel's		
	Slayer's		
	Berserker's		
	Slayer's		
	Berserker's		
	Slayer's		
	Berserker's		
	Shaman's		
	Hierophant's		
	Shaman's		
	Hierophant's		
	Magekiller's		
	Witch-hunter's		
	Magekiller's		
	Witch-hunter's		
	Compact		
	Thin		
	Dense		
	Consecrated		
	Pure		
	Sacred		
	Hallowed		
	Divine		
	Pearl		
	Crimson		
	Red		
	Sanguinary		
	Bloody		
	Red		
	Sanguinary		
	Red		
	Jagged		
	Forked		
	Serrated		
	Jagged		
	Forked		
	Jagged		
	Snowflake		
	Shivering		
	Boreal		
	Hibernal		
	Snowflake		
	Shivering		
	Boreal		
	Hibernal		
	Snowflake		
	Shivering		
	Boreal		
	Hibernal		
	Ember		
	Smoldering		
	Smoking		
	Flaming		
	Ember		
	Smoldering		
	Smoking		
	Flaming		
	Ember		
	Smoldering		
	Smoking		
	Flaming		
	Static		
	Glowing		
	Arcing		
	Shocking		
	Static		
	Glowing		
	Arcing		
	Shocking		
	Static		
	Glowing		
	Arcing		
	Shocking		
	Septic		
	Envenomed		
	Toxic		
	Pestilent		
	Septic		
	Envenomed		
	Toxic		
	Pestilent		
	Septic		
	Envenomed		
	Toxic		
	Pestilent		
	Tireless		
	Lizard's		
	Azure		
	Crimson		
	Tangerine		
	Beryl		
	Godly		
	Cruel		
*=======================以下是魔法后缀(Magic Suffix)			
0			
	of Health		
	of Protection		
	of Absorption		
	of Life		
5			
	of Warding		
	of the Sentinel		
	of Guarding		
	of Negation		
10			
	of Piercing		
	of Bashing		
	of Puncturing		
	of Thorns		
	of Spikes		
	of Readiness		
	of Alacrity		
	of Swiftness		
	of Quickness		
	of Blocking		
	of Deflecting		
	of the Apprentice		
	of the Magus		
	of Frost		
	of the Glacier		
	of Frost		
	of Warmth		
	of Flame		
	of Fire		
	of Burning		
	of Flame		
	of Shock		
	of Lightning		
	of Thunder		
	of Shock		
	of Craftsmanship		
	of Quality		
	of Maiming		
	of Slaying		
	of Gore		
	of Carnage		
	of Slaughter		
	of Maiming		
	of Worth		
	of Measure		
	of Excellence		
	of Performance		
	of Measure		
	of Blight		
	of Venom		
	of Pestilence		
	of Blight		
	of Dexterity		
	of Dexterity		
	of Skill		
	of Skill		
	of Accuracy		
	of Precision		
	of Precision		
	of Perfection		
	of Balance		
	of Stability		
63			
	of Regeneration		
	of Regeneration		
	of Regeneration		
	of Regrowth		
	of Regrowth		
	of Vileness		
70			
	of Greed		
	of Wealth		
	of Chance		
	of Fortune		
	of Energy		
	of Energy		
	of the Mind		
	of Brilliance		
	of Sorcery		
	of Wizardry		
	of the Bear		
	of Light		
	of Radiance		
	of the Sun		
	of Life		
	of the Jackal		
	of the Fox		
	of the Wolf		
	of the Wolf		
	of the Tiger		
	of the Mammoth		
	of the Mammoth		
	of the Colosuss		
	of the Leech		
	of the Locust		
	of the Bat		
	of the Vampire		
	of Defiance		
	of Amelioration		
	of Remedy		
101			
	of Simplicity		
	of Ease		
104			
	of Strength		
	of Might		
	of the Ox		
	of the Ox		
	of the Giant		
	of the Giant		
	of the Titan		
	of Pacing		
	of Haste		
	of Speed		
	of Health		
	of Protection		
	of Absorption		
	of Life		
	of Life Everlasting		
	of Protection		
	of Absorption		
	of Life		
	of Anima		
	of Warding		
	of the Sentinel		
	of Guarding		
	of Negation		
	of the Sentinel		
	of Guarding		
	of Negation		
	of Coolness		
	of Incombustibility		
	of Amianthus		
	of Fire Quenching		
	of Coolness		
	of Incombustibility		
	of Amianthus		
	of Fire Quenching		
	of Faith		
	of Resistance		
	of Insulation		
	of Grounding		
	of the Dynamo		
	of Resistance		
	of Insulation		
	of Grounding		
	of the Dynamo		
	of Stoicism		
	of Warming		
	of Thawing		
	of the Dunes		
	of the Sirocco		
	of Warming		
	of Thawing		
	of the Dunes		
	of the Sirocco		
	of Desire		
	of Piercing		
	of Bashing		
	of Puncturing		
	of Thorns		
	of Spikes		
	of Razors		
	of Swords		
	of Malice		
	of Readiness		
	of Alacrity		
	of Swiftness		
	of Quickness		
	of Alacrity		
	of Fervor		
	of Blocking		
	of Deflecting		
	of the Apprentice		
	of the Magus		
	of Frost		
	of the Icicle		
	of the Glacier		
	of Winter		
	of Frost		
	of Frigidity		
	of Warmth		
	of Flame		
	of Fire		
	of Burning		
	of Incineration		
	of Flame		
	of Passion		
	of Shock		
	of Lightning		
	of Thunder		
	of Storms		
	of Shock		
	of Ennui		
	of Craftsmanship		
	of Quality		
	of Maiming		
	of Slaying		
	of Gore		
	of Carnage		
	of Slaughter		
	of Butchery		
	of Evisceration		
	of Maiming		
	of Craftsmanship		
	of Craftsmanship		
	of Craftsmanship		
	of Quality		
	of Quality		
	of Maiming		
	of Maiming		
	of Craftsmanship		
	of Craftsmanship		
	of Quality		
	of Quality		
	of Maiming		
	of Craftsmanship		
	of Quality		
	of Maiming		
	of Ire		
	of Wrath		
	of Carnage		
	of Worth		
	of Measure		
	of Excellence		
	of Performance		
	of Transcendence		
	of Worth		
	of Measure		
	of Excellence		
	of Performance		
	of Joyfulness		
	of Bliss		
	of Blight		
	of Venom		
	of Pestilence		
	of Anthrax		
	of Blight		
	of Envy		
	of Dexterity		
	of Skill		
	of Accuracy		
	of Precision		
	of Perfection		
	of Nirvana		
	of Dexterity		
	of Skill		
	of Accuracy		
	of Precision		
	of Perfection		
	of Dexterity		
	of Skill		
	of Accuracy		
	of Precision		
	of Dexterity		
	of Dexterity		
	of Dexterity		
	of Dexterity		
	of Dexterity		
	of Dexterity		
	of Daring		
	of Balance		
	of Equilibrium		
	of Stability		
	of Balance		
	of Balance		
	of Balance		
	of Truth		
	of Regeneration		
	of Regeneration		
	of Regeneration		
	of Regrowth		
	of Regrowth		
	of Revivification		
	of Honor		
	of Vileness		
	of Greed		
	of Wealth		
	of Greed		
	of Greed		
	of Greed		
	of Greed		
	of Greed		
	of Greed		
	of Avarice		
	of Chance		
	of Fortune		
	of Fortune		
	of Luck		
	of Fortune		
	of Good Luck		
	of Prosperity		
	of Energy		
	of the Mind		
	of Brilliance		
	of Sorcery		
	of Wizardry		
	of Enlightenment		
	of Energy		
	of the Mind		
	of Brilliance		
	of Sorcery		
	of Wizardry		
	of Energy		
	of the Mind		
	of Brilliance		
	of Sorcery		
	of Knowledge		
	of the Bear		
	of Light		
	of Radiance		
	of the Sun		
	of the Jackal		
	of the Fox		
	of the Wolf		
	of the Tiger		
	of the Mammoth		
	of the Colosuss		
	of the Squid		
	of the Whale		
	of the Jackal		
	of the Fox		
	of the Wolf		
	of the Tiger		
	of the Mammoth		
	of the Colosuss		
	of the Jackal		
	of the Fox		
	of the Wolf		
	of the Tiger		
	of the Mammoth		
	of Life		
	of Life		
	of Life		
	of Substinence		
	of Substinence		
	of Substinence		
	of Vita		
	of Vita		
	of Vita		
	of Life		
	of Life		
	of Substinence		
	of Substinence		
	of Vita		
	of Vita		
	of Life		
	of Substinence		
	of Vita		
	of Spirit		
	of Hope		
	of the Leech		
	of the Locust		
	of the Lamprey		
	of the Leech		
	of the Locust		
	of the Lamprey		
	of the Leech		
	of the Bat		
	of the Wraith		
	of the Vampire		
	of the Bat		
	of the Wraith		
	of the Vampire		
	of the Bat		
	of Defiance		
	of Amelioration		
	of Remedy		
	of Simplicity		
	of Ease		
	of Freedom		
	of Strength		
	of Might		
	of the Ox		
	of the Giant		
	of the Titan		
	of Atlus		
	of Strength		
	of Might		
	of the Ox		
	of the Giant		
	of the Titan		
	of Strength		
	of Might		
	of the Ox		
	of the Giant		
	of Strength		
	of Strength		
	of Strength		
	of Strength		
	of Strength		
	of Strength		
	of Virility		
	of Pacing		
	of Haste		
	of Speed		
	of Traveling		
	of Acceleration		
	of Inertia		
	of Inertia		
	of Inertia		
	of Self-Repair		
	of Fast Repair		
	of Ages		
	of Replenishing		
	of Propogation		
	of the Kraken		
	of Memory		
	of the Elephant		
	of Power		
	of Grace		
	of Grace and Power		
	of the Yeti		
	of the Phoenix		
	of the Efreeti		
	of the Cobra		
	of the Elements		
	of Firebolts		
	of Firebolts		
	of Firebolts		
	of Charged Shield		
	of Charged Shield		
	of Charged Shield		
	of Icebolt		
	of Frozen Armor		
	of Static Field		
	of Telekinesis		
	of Frost Shield		
	of Ice Blast		
	of Blaze		
	of Fire Ball		
	of Nova		
	of Nova		
	of Nova Shield		
	of Nova Shield		
	of Nova Shield		
	of Lightning		
	of Lightning		
	of Shiver Armor		
	of Fire Wall		
	of Enchant		
	of Chain Lightning		
	of Chain Lightning		
	of Chain Lightning		
	of Teleport Shield		
	of Teleport Shield		
	of Teleport Shield		
	of Glacial Spike		
	of Meteor		
	of Thunder Storm		
	of Energy Shield		
	of Blizzard		
	of Chilling Armor		
	of Hydra Shield		
	of Frozen Orb		
	of Dawn		
	of Sunlight		
	of Magic Arrows		
	of Magic Arrows		
	of Fire Arrows		
	of Fire Arrows		
	of Inner Sight		
	of Inner Sight		
	of Jabbing		
	of Jabbing		
	of Cold Arrows		
	of Cold Arrows		
	of Multiple Shot		
	of Multiple Shot		
	of Power Strike		
	of Power Strike		
	of Poison Jab		
	of Poison Jab		
	of Exploding Arrows		
	of Exploding Arrows		
	of Slow Missiles		
	of Slow Missiles		
	of Impaling Strike		
	of Impaling Strike		
	of Lightning Javelin		
	of Lightning Javelin		
	of Ice Arrows		
	of Ice Arrows		
	of Guided Arrows		
	of Guided Arrows		
	of Charged Strike		
	of Charged Strike		
	of Plague Jab		
	of Plague Jab		
	of Immolating Arrows		
	of Immolating Arrows		
	of Fending		
	of Fending		
	of Freezing Arrows		
	of Freezing Arrows		
	of Lightning Strike		
	of Lightning Strike		
	of Lightning Fury		
	of Lightning Fury		
	of Fire Bolts		
	of Fire Bolts		
	of Charged Bolts		
	of Charged Bolts		
	of Ice Bolts		
	of Ice Bolts		
	of Frozen Armor		
	of Frozen Armor		
	of Static Field		
	of Static Field		
	of Telekinesis		
	of Telekinesis		
	of Frost Novas		
	of Frost Novas		
	of Ice Blasts		
	of Ice Blasts		
	of Blazing		
	of Blazing		
	of Fire Balls		
	of Fire Balls		
	of Novas		
	of Novas		
	of Lightning		
	of Lightning		
	of Shiver Armor		
	of Shiver Armor		
	of Fire Walls		
	of Fire Walls		
	of Enchantment		
	of Enchantment		
	of Chain Lightning		
	of Chain Lightning		
	of Teleportation		
	of Teleportation		
	of Glacial Spikes		
	of Glacial Spikes		
	of Meteors		
	of Meteors		
	of Thunder Storm		
	of Thunder Storm		
	of Energy Shield		
	of Energy Shield		
	of Blizzards		
	of Blizzards		
	of Chilling Armor		
	of Chilling Armor		
	of Hydras		
	of Hydras		
	of Frozen Orbs		
	of Frozen Orbs		
	of Amplify Damage		
	of Amplify Damage		
	of Teeth		
	of Teeth		
	of Bone Armor		
	of Bone Armor		
	of Raise Skeletons		
	of Raise Skeletons		
	of Dim Vision		
	of Dim Vision		
	of Weaken		
	of Weaken		
	of Poison Dagger		
	of Poison Dagger		
	of Corpse Explosions		
	of Corpse Explosions		
	of Clay Golem Summoning		
	of Clay Golem Summoning		
	of Iron Maiden		
	of Iron Maiden		
	of Terror		
	of Terror		
	of Bone Walls		
	of Bone Walls		
	of Raise Skeletal Mages		
	of Raise Skeletal Mages		
	of Confusion		
	of Confusion		
	of Life Tap		
	of Life Tap		
	of Poison Explosion		
	of Poison Explosion		
	of Bone Spears		
	of Bone Spears		
	of Blood Golem Summoning		
	of Blood Golem Summoning		
	of Attraction		
	of Attraction		
	of Decrepification		
	of Decrepification		
	of Bone Imprisonment		
	of Bone Imprisonment		
	of Iron Golem Creation		
	of Iron Golem Creation		
	of Lower Resistance		
	of Lower Resistance		
	of Poison Novas		
	of Poison Novas		
	of Bone Spirits		
	of Bone Spirits		
	of Fire Golem Summoning		
	of Fire Golem Summoning		
	of Revivification		
	of Revivification		
	of Sacrifice		
	of Sacrifice		
	of Holy Bolts		
	of Holy Bolts		
	of Zeal		
	of Zeal		
	of Vengeance		
	of Vengeance		
	of Blessed Hammers		
	of Blessed Hammers		
	of Conversion		
	of Conversion		
	of Fist of the Heavens		
	of Fist of the Heavens		
	of Bashing		
	of Bashing		
	of Howling		
	of Howling		
	of Potion Finding		
	of Potion Finding		
	of Taunting		
	of Taunting		
	of Shouting		
	of Shouting		
	of Stunning		
	of Stunning		
	of Item Finding		
	of Item Finding		
	of Concentration		
	of Concentration		
	of Battle Cry		
	of Battle Cry		
	of Battle Orders		
	of Battle Orders		
	of Grim Ward		
	of Grim Ward		
	of War Cry		
	of War Cry		
	of Battle Command		
	of Battle Command		
	of Firestorms		
	of Firestorms		
	of Molten Boulders		
	of Molten Boulders		
	of Eruption		
	of Eruption		
	of Cyclone Armor		
	of Cyclone Armor		
	of Twister		
	of Twister		
	of Volcano		
	of Volcano		
	of Tornado		
	of Tornado		
	of Armageddon		
	of Armageddon		
	of Hurricane		
	of Hurricane		
	of Damage Amplification		
	of the Icicle		
	of the Glacier		
	of Fire		
	of Burning		
	of Lightning		
	of Thunder		
	of Daring		
	of Daring		
	of Knowledge		
	of Knowledge		
	of Virility		
	of Virility		
	of Readiness		
	of Craftsmanship		
	of Quality		
	of Maiming		
	of Craftsmanship		
	of Quality		
	of Craftsmanship		
	of Blight		
	of Venom		
	of Pestilence		
	of Anthrax		
	of Blight		
	of Venom		
	of Pestilence		
	of Anthrax		
	of Blight		
	of Venom		
	of Pestilence		
	of Anthrax		
	of Frost		
	of the Icicle		
	of the Glacier		
	of Winter		
	of Frost		
	of the Icicle		
	of the Glacier		
	of Winter		
	of Frost		
	of the Icicle		
	of the Glacier		
	of Winter		
	of Flame		
	of Fire		
	of Burning		
	of Incineration		
	of Flame		
	of Fire		
	of Burning		
	of Incineration		
	of Flame		
	of Fire		
	of Burning		
	of Incineration		
	of Shock		
	of Lightning		
	of Thunder		
	of Storms		
	of Shock		
	of Lightning		
	of Thunder		
	of Storms		
	of Shock		
	of Lightning		
	of Thunder		
	of Storms		
	of Dexterity		
	of Dexterity		
	of Strength		
	of Strength		
	of Thorns		
	of Frost		
	of Flame		
	of Blight		
	of Shock		
	of Regeneration		
	of Energy		
	of Light		
	of the Leech		
	of the Locust		
	of the Lamprey		
	of the Bat		
	of the Wraith		
	of the Vampire		
*=======================以下是Rare和Crafted名字			
0			
	Bite		
	Scratch		
	Scalpel		
	Fang		
	Gutter		
	Thirst		
	Razor		
	Scythe		
	Edge		
	Saw		
	Splitter		
	Cleaver		
	Sever		
	Sunder		
	Rend		
	Mangler		
	Slayer		
	Reaver		
	Spawn		
	Gnash		
	Star		
	Blow		
	Smasher		
	Bane		
	Crusher		
	Breaker		
	Grinder		
	Crack		
	Mallet		
	Knell		
	Lance		
	Spike		
	Impaler		
	Skewer		
	Prod		
	Scourge		
	Wand		
	Wrack		
	Barb		
	Needle		
	Dart		
	Bolt		
	Quarrel		
	Fletch		
	Flight		
	Nock		
	Horn		
	Stinger		
	Quill		
	Goad		
	Branch		
	Spire		
	Song		
	Call		
	Cry		
	Spell		
	Chant		
	Weaver		
	Gnarl		
	Visage		
	Crest		
	Circlet		
	Veil		
	Hood		
	Mask		
	Brow		
	Casque		
	Visor		
	Cowl		
	Hide		
	Pelt		
	Carapace		
	Coat		
	Wrap		
	Suit		
	Cloak		
	Shroud		
	Jack		
	Mantle		
	Guard		
	Badge		
	Rock		
	Aegis		
	Ward		
	Tower		
	Shield		
	Wing		
	Mark		
	Emblem		
	Hand		
	Fist		
	Claw		
	Clutches		
	Grip		
	Grasp		
	Hold		
	Touch		
	Finger		
	Knuckle		
	Shank		
	Spur		
	Tread		
	Stalker		
	Greaves		
	Blazer		
	Nails		
	Trample		
	Brogues		
	Track		
	Slippers		
	Clasp		
	Buckle		
	Harness		
	Lock		
	Fringe		
	Winding		
	Chain		
	Strap		
	Lash		
	Cord		
	Knot		
	Circle		
	Loop		
	Eye		
	Turn		
	Spiral		
	Coil		
	Gyre		
	Band		
	Whorl		
	Talisman		
	Heart		
	Noose		
	Necklace		
	Collar		
	Beads		
	Torc		
	Gorget		
	Scarab		
	Wood		
	Brand		
	Bludgeon		
	Cudgel		
	Loom		
	Harp		
	Master		
	Bar		
	Hew		
	Crook		
	Mar		
	Shell		
	Stake		
	Picket		
	Pale		
	Flange		
	Beast		
	Eagle		
	Raven		
	Viper		
	Ghoul		
	Skull		
	Blood		
	Dread		
	Doom		
	Grim		
	Bone		
	Death		
	Shadow		
	Storm		
	Rune		
	Plague		
	Stone		
	Wraith		
	Spirit		
	Storm		
	Demon		
	Cruel		
	Empyrian		
	Bramble		
	Pain		
	Loath		
	Glyph		
	Imp		
	Fiend		
	Hailstone		
	Gale		
	Dire		
	Soul		
	Brimstone		
	Corpse		
	Carrion		
	Armageddon		
	Havoc		
	Bitter		
	Entropy		
	Chaos		
	Order		
	Rule		
	Warp		
	Rift		
	Corruption		
*=======================以下是暗金名字(Unique Name)			
	The Gnasher		
	Deathspade		
	Bladebone		
	Mindrend		
	Rakescar		
	Fechmars Axe		
	Goreshovel		
	The Chieftan		
	Brainhew		
	The Humongous		
	Iros Torch		
	Maelstromwrath		
	Gravenspine		
	Umes Lament		
	Felloak		
	Knell Striker		
	Rusthandle		
	Stormeye		
	Stoutnail		
	Crushflange		
	Bloodrise		
	The Generals Tan Do Li Ga		
	Ironstone		
	Bonesob		
	Steeldriver		
	Rixots Keen		
	Blood Crescent		
	Krintizs Skewer		
	Gleamscythe		
	Azurewrath		
	Griswolds Edge		
	Hellplague		
	Culwens Point		
	Shadowfang		
	Soulflay		
	Kinemils Awl		
	Blacktongue		
	Ripsaw		
	The Patriarch		
	Gull		
	The Diggler		
	The Jade Tan Do		
	Irices Shard		
	The Dragon Chang		
	Razortine		
	Bloodthief		
	Lance of Yaggai		
	The Tannr Gorerod		
	Dimoaks Hew		
	Steelgoad		
	Soul Harvest		
	The Battlebranch		
	Woestave		
	The Grim Reaper		
	Bane Ash		
	Serpent Lord		
	Lazarus Spire		
	The Salamander		
	The Iron Jang Bong		
	Pluckeye		
	Witherstring		
	Rimeraven		
	Piercerib		
	Pullspite		
	Wizendraw		
	Hellclap		
	Blastbark		
	Leadcrow		
	Ichorsting		
	Hellcast		
	Doomspittle		
	War Bonnet		
	Tarnhelm		
	Coif of Glory		
	Duskdeep		
	Wormskull		
	Howltusk		
	Undead Crown		
	The Face of Horror		
	Greyform		
	Blinkbats Form		
	The Centurion		
	Twitchthroe		
	Darkglow		
	Hawkmail		
	Sparking Mail		
	Venomsward		
	Iceblink		
	Boneflesh		
	Rockfleece		
	Rattlecage		
	Goldskin		
	Victors Silk		
	Heavenly Garb		
	Pelta Lunata		
	Umbral Disk		
	Stormguild		
	Wall of the Eyeless		
	Swordback Hold		
	Steelclash		
	Bverrit Keep		
	The Ward		
	The Hand of Broc		
	Bloodfist		
	Chance Guards		
	Magefist		
	Frostburn		
	Hotspur		
	Gorefoot		
	Treads of Cthon		
	Goblin Toe		
	Tearhaunch		
	Lenyms Cord		
	Snakecord		
	Nightsmoke		
	Goldwrap		
	Bladebuckle		
	Nokozan Relic		
	The Eye of Etlich		
	The Mahim-Oak Curio		
	Nagelring		
	Manald Heal		
	The Stone of Jordan		
	Amulet of the Viper		
	Staff of Kings		
	Horadric Staff		
	Hell Forge Hammer		
	Khalim's Flail		
	Khalim's Will		
	Coldkill		
	Butcher's Pupil		
	Islestrike		
	Pompe's Wrath		
	Guardian Naga		
	Warlord's Trust		
	Spellsteel		
	Stormrider		
	Boneslayer Blade		
	The Minataur		
	Suicide Branch		
	Carin Shard		
	Arm of King Leoric		
	Blackhand Key		
	Dark Clan Crusher		
	Zakarum's Hand		
	The Fetid Sprinkler		
	Hand of Blessed Light		
	Fleshrender		
	Sureshrill Frost		
	Moonfall		
	Baezil's Vortex		
	Earthshaker		
	Bloodtree Stump		
	The Gavel of Pain		
	Bloodletter		
	Coldsteel Eye		
	Hexfire		
	Blade of Ali Baba		
	Ginther's Rift		
	Headstriker		
	Plague Bearer		
	The Atlantian		
	Crainte Vomir		
	Bing Sz Wang		
	The Vile Husk		
	Cloudcrack		
	Todesfaelle Flamme		
	Swordguard		
	Spineripper		
	Heart Carver		
	Blackbog's Sharp		
	Stormspike		
	The Impaler		
	Kelpie Snare		
	Soulfeast Tine		
	Hone Sundan		
	Spire of Honor		
	The Meat Scraper		
	Blackleach Blade		
	Athena's Wrath		
	Pierre Tombale Couant		
	Husoldal Evo		
	Grim's Burning Dead		
	Razorswitch		
	Ribcracker		
	Chromatic Ire		
	Warpspear		
	Skullcollector		
	Skystrike		
	Riphook		
	Kuko Shakaku		
	Endlesshail		
	Whichwild String		
	Cliffkiller		
	Magewrath		
	Godstrike Arch		
	Langer Briser		
	Pus Spiter		
	Buriza-Do Kyanon		
	Demon Machine		
	Armor		
	Peasent Crown		
	Rockstopper		
	Stealskull		
	Darksight Helm		
	Valkiry Wing		
	Crown of Thieves		
	Blackhorn's Face		
	Vampiregaze		
	The Spirit Shroud		
	Skin of the Vipermagi		
	Skin of the Flayerd One		
	Ironpelt		
	Spiritforge		
	Crow Caw		
	Shaftstop		
	Duriel's Shell		
	Skullder's Ire		
	Guardian Angel		
	Toothrow		
	Atma's Wail		
	Black Hades		
	Corpsemourn		
	Que-Hegan's Wisdon		
	Visceratuant		
	Mosers Blessed Circle		
	Stormchaser		
	Tiamat's Rebuke		
	Kerke's Sanctuary		
	Radimant's Sphere		
	Lidless Wall		
	Lance Guard		
	Venom Grip		
	Gravepalm		
	Ghoulhide		
	Lavagout		
	Hellmouth		
	Infernostride		
	Waterwalk		
	Silkweave		
	Wartraveler		
	Gorerider		
	String of Ears		
	Razortail		
	Gloomstrap		
	Snowclash		
	Thudergod's Vigor		
	Elite Uniques		
	Harlequin Crest		
	Veil of Steel		
	The Gladiator's Bane		
	Arkaine's Valor		
	Blackoak Shield		
	Stormshield		
	Hellslayer		
	Messerschmidt's Reaver		
	Baranar's Star		
	Schaefer's Hammer		
	The Cranium Basher		
	Lightsabre		
	Doombringer		
	The Grandfather		
	Wizardspike		
	Constricting Ring		
	Stormspire		
	Eaglehorn		
	Windforce		
	Rings		
	Bul Katho's Wedding Band		
	The Cat's Eye		
	The Rising Sun		
	Crescent Moon		
	Mara's Kaleidoscope		
	Atma's Scarab		
	Dwarf Star		
	Raven Frost		
	Highlord's Wrath		
	Saracen's Chance		
	Class Specific		
	Arreat's Face		
	Homunculus		
	Titan's Revenge		
	Lycander's Aim		
	Lycander's Flank		
	The Oculus		
	Herald of Zakarum		
	Cutthroat1		
	Jalal's Mane		
	The Scalper		
	Bloodmoon		
	Djinnslayer		
	Deathbit		
	Warshrike		
	Gutsiphon		
	Razoredge		
	Gore Ripper		
	Demonlimb		
	Steelshade		
	Tomb Reaver		
	Deaths's Web		
	Nature's Peace		
	Azurewrath		
	Seraph's Hymn		
	Zakarum's Salvation		
	Fleshripper		
	Odium		
	Horizon's Tornado		
	Stone Crusher		
	Jadetalon		
	Shadowdancer		
	Cerebus' Bite		
	Tyrael's Might		
	Souldrain		
	Runemaster		
	Deathcleaver		
	Executioner's Justice		
	Stoneraven		
	Leviathan		
	Larzuk's Champion		
	Wisp Projector		
	Gargoyle's Bite		
	Lacerator		
	Mang Song's Lesson		
	Viperfork		
	Ethereal Edge		
	Demonhorn's Edge		
	The Reaper's Toll		
	Spiritkeeper		
	Hellrack		
	Alma Negra		
	Darkforge Spawn		
	Widowmaker		
	Bloodraven's Charge		
	Ghostflame		
	Shadowkiller		
	Gimmershred		
	Griffon's Eye		
	Windhammer		
	Thunderstroke		
	Giantmaimer		
	Demon's Arch		
	Boneflame		
	Steelpillar		
	Nightwing's Veil		
	Crown of Ages		
	Andariel's Visage		
	Darkfear		
	Dragonscale		
	Steel Carapice		
	Medusa's Gaze		
	Ravenlore		
	Boneshade		
	Nethercrow		
	Flamebellow		
	Fathom		
	Wolfhowl		
	Spirit Ward		
	Kira's Guardian		
	Ormus' Robes		
	Gheed's Fortune		
	Stormlash		
	Halaberd's Reign		
	Warriv's Warder		
	Spike Thorn		
	Dracul's Grasp		
	Frostwind		
	Templar's Might		
	Eschuta's temper		
	Firelizard's Talons		
	Sandstorm Trek		
	Marrowwalk		
	Heaven's Light		
	Merman's Speed		
	Arachnid Mesh		
	Nosferatu's Coil		
	Metalgrid		
	Verdugo's Hearty Cord		
	Sigurd's Staunch		
	Carrion Wind		
	Giantskull		
	Ironward		
	Annihilus		
	Arioc's Needle		
	Cranebeak		
	Nord's Tenderizer		
	Earthshifter		
	Wraithflight		
	Bonehew		
	Ondal's Wisdom		
	The Reedeemer		
	Headhunter's Glory		
	Steelrend		
	Rainbow Facet		
	Rainbow Facet		
	Rainbow Facet		
	Rainbow Facet		
	Rainbow Facet		
	Rainbow Facet		
	Rainbow Facet		
	Rainbow Facet		
	Hellfire Torch	地狱火炬	地z火炬
*=======================以下是套装名字(Set Name)			
	Civerb's Ward		
	Civerb's Icon		
	Civerb's Cudgel		
	Hsarus' Iron Heel		
	Hsarus' Iron Fist		
	Hsarus' Iron Stay		
	Cleglaw's Tooth		
	Cleglaw's Claw		
	Cleglaw's Pincers		
	Iratha's Collar		
	Iratha's Cuff		
	Iratha's Coil		
	Iratha's Cord		
	Isenhart's Lightbrand		
	Isenhart's Parry		
	Isenhart's Case		
	Isenhart's Horns		
	Vidala's Barb		
	Vidala's Fetlock		
	Vidala's Ambush		
	Vidala's Snare		
	Milabrega's Orb		
	Milabrega's Rod		
	Milabrega's Diadem		
	Milabrega's Robe		
	Cathan's Rule		
	Cathan's Mesh		
	Cathan's Visage		
	Cathan's Sigil		
	Cathan's Seal		
	Tancred's Crowbill		
	Tancred's Spine		
	Tancred's Hobnails		
	Tancred's Weird		
	Tancred's Skull		
	Sigon's Gage		
	Sigon's Visor		
	Sigon's Shelter		
	Sigon's Sabot		
	Sigon's Wrap		
	Sigon's Guard		
	Infernal Cranium		
	Infernal Torch		
	Infernal Sign		
	Berserker's Headgear		
	Berserker's Hauberk		
	Berserker's Hatchet		
	Death's Hand		
	Death's Guard		
	Death's Touch		
	Angelic Sickle		
	Angelic Mantle		
	Angelic Halo		
	Angelic Wings		
	Arctic Horn		
	Arctic Furs		
	Arctic Binding		
	Arctic Mitts		
	Arcanna's Sign		
	Arcanna's Deathwand		
	Arcanna's Head		
	Arcanna's Flesh		
	Natalya's Totem		
	Natalya's Mark		
	Natalya's Shadow		
	Natalya's Soul		
	Aldur's Stony Gaze		
	Aldur's Deception		
	Aldur's Gauntlet		
	Aldur's Advance		
	Immortal King's Will		
	Immortal King's Soul Cage 		
	Immortal King's Detail		
	Immortal King's Forge		
	Immortal King's Pillar		
	Immortal King's Stone Crusher		
	Tal Rasha's Fire-Spun Cloth		
	Tal Rasha's Adjudication		
	Tal Rasha's Lidless Eye		
	Tal Rasha's Guardianship		
	Tal Rasha's Horadric Crest		
	Griswold's Valor		
	Griswold's Heart		
	Griswolds's Redemption		
	Griswold's Honor		
	Trang-Oul's Guise		
	Trang-Oul's Scales		
	Trang-Oul's Wing		
	Trang-Oul's Claws		
	Trang-Oul's Girth		
	M'avina's True Sight		
	M'avina's Embrace		
	M'avina's Icy Clutch		
	M'avina's Tenet		
	M'avina's Caster		
	Telling of Beads		
	Laying of Hands		
	Rite of Passage		
	Spiritual Custodian		
	Credendum		
	Dangoon's Teaching		
	Heaven's Taebaek		
	Haemosu's Adament		
	Ondal's Almighty		
	Guillaume's Face		
	Wilhelm's Pride		
	Magnus' Skin		
	Wihtstan's Guard		
	Hwanin's Splendor		
	Hwanin's Refuge		
	Hwanin's Seal		
	Hwanin's Justice		
	Sazabi's Cobalt Redeemer		
	Sazabi's Ghost Liberator		
	Sazabi's Mental Sheath		
	Bul-Kathos' Sacred Charge		
	Bul-Kathos' Tribal Guardian		
	Cow King's Horns		
	Cow King's Hide		
	Cow King's Hoofs		
	Naj's Puzzler		
	Naj's Light Plate		
	Naj's Circlet		
	McAuley's Paragon		
	McAuley's Riprap		
	McAuley's Taboo		
	McAuley's Superstition		
*=======================以下是符文之语名字(Rune Name)			
27	Ancient's Pledge		
30	Beast		
32	Black		
34	Bone		
35	Bramble		
36	Brand		
37	Breath of the Dying		
39	Call to Arms		
40	Chains of Honor		
42	Chaos		
43	Crescent Moon		
46	Death		
51	Destruction		
52	Doom		
53	Dragon		
55	Dream		
56	Duress		
57	Edge		
59	Enigma		
60	Enlightenment		
62	Eternity		
63	Exile		
64	Faith		
65	Famine		
67	Fortitude		
70	Fury		
71	Gloom		
73	Grief		
74	Hand of Justice		
75	Harmory		
77	Heart of the Oak		
80	Holy Thunder		
81	Honor		
85	Ice		
86	Infinity		
88	Insight		
91	King's Grace		
92	Kingslayer		
95	Last Wish		
97	Lawbringer		
98	Leaf		
100	Lionheart		
101	Lore		
106	Malice		
107	Melody		
108	Memory		
112	Myth		
113	Nadir		
116	Oath		
117	Obedience		
120	Passion		
123	Peace		
124	Winter		
128	Phoenix		
134	Pride		
135	Principle		
137	Prudence		
141	Radiance		
142	Rain		
145	Rhyme		
146	Rift		
147	Sanctuary		
151	Silence		
153	Smoke		
155	Spirit		
156	Splendor		
158	Stealth		
159	Steel		
162	Stone		
164	Strength		
173	Treachery		
179	Venom		
185	Wealth		
187	White		
188	Wind		
193	Wrath		
195	Zephyr		
2718	Delirium		
